Species	Common	Category
× Triticosecale	Triticale	Domesticated Plant Khouri et al. 2016
Abelmoschus esculentus	Okra	Domesticated Plant Khouri et al. 2016
Actinidea	Kiwi	Domesticated Plant Khouri et al. 2016
Allium cepa	Onions	Domesticated Plant Khouri et al. 2016
Allium porrum	Leeks	Domesticated Plant Khouri et al. 2016
Allium sativum	Garlic	Domesticated Plant Khouri et al. 2016
Anacardium occidentale	Cashew	Domesticated Plant Khouri et al. 2016
Ananas comosus	Pineapples	Domesticated Plant Khouri et al. 2016
Arachis hypogaea	Groundnut	Domesticated Plant Khouri et al. 2016
Areca catechu	Areca nuts	Domesticated Plant Khouri et al. 2016
Asparagus officinalis	Asparagus	Domesticated Plant Khouri et al. 2016
Avena sativa	Oats	Domesticated Plant Khouri et al. 2016
Bertholletia excelsa	Brazil nuts	Domesticated Plant Khouri et al. 2016
Beta vulgaris	Sugar beet	Domesticated Plant Khouri et al. 2016
Brassica juncea	Mustard spice	Domesticated Plant Khouri et al. 2016
Brassica napus	Rapeseed	Domesticated Plant Khouri et al. 2016
Brassica oleracea	Cabbages	Domesticated Plant Khouri et al. 2016
Brassica rapa	Turnips	Domesticated Plant Khouri et al. 2016
Cajanus cajan	Pigeonpeas	Domesticated Plant Khouri et al. 2016
Camellia sinensis	Tea	Domesticated Plant Khouri et al. 2016
Cannabis sativa	Hempseed	Domesticated Plant Khouri et al. 2016
Capsicum	Chillies and Peppers	Domesticated Plant Khouri et al. 2016
Capsicum annuum	Bell Pepper	Domesticated Plant Khouri et al. 2016
Capsicum chinense	Habenero	Domesticated Plant Khouri et al. 2016
Carica papaya	Papayas	Domesticated Plant Khouri et al. 2016
Carthamus tinctorius	Safflower seed	Domesticated Plant Khouri et al. 2016
Castanea sativa	Chestnut	Domesticated Plant Khouri et al. 2016
Cenchrus americanus	Pearl millet	Domesticated Plant Khouri et al. 2016
Ceratonia siliqua	Carob	Domesticated Plant Khouri et al. 2016
Chenopodium quinoa	Quinoa	Domesticated Plant Khouri et al. 2016
Cicer arietinum	Chickpeas	Domesticated Plant Khouri et al. 2016
Cichorium intybus	Chicory roots	Domesticated Plant Khouri et al. 2016
Cinnamomum	Cinnamon	Domesticated Plant Khouri et al. 2016
Citrullus lanatus	Watermelons	Domesticated Plant Khouri et al. 2016
Citrus	Citrus	Domesticated Plant Khouri et al. 2016
Cocos nucifera	Coconuts	Domesticated Plant Khouri et al. 2016
Coffea arabica	Arabica coffee	Domesticated Plant Khouri et al. 2016
Coffea canephora	Robusta coffee	Domesticated Plant Khouri et al. 2016
Cola	Kola nuts	Domesticated Plant Khouri et al. 2016
Colocasia esculenta	Taro	Domesticated Plant Khouri et al. 2016
Coriandrum sativum	Coriander	Domesticated Plant Khouri et al. 2016
Corylus avellana	Hazelnuts	Domesticated Plant Khouri et al. 2016
Cucumis melo	Melons	Domesticated Plant Khouri et al. 2016
Cucumis sativus	Cucumbers	Domesticated Plant Khouri et al. 2016
Cucurbita maxima	Winter squash	Domesticated Plant Khouri et al. 2016
Cucurbita moschata	Butternut squash	Domesticated Plant Khouri et al. 2016
Cucurbita pepo	Pumpkin	Domesticated Plant Khouri et al. 2016
Cydonia oblonga	Quinces	Domesticated Plant Khouri et al. 2016
Cynara cardunculus	Artichokes	Domesticated Plant Khouri et al. 2016
Daucus carota	Carrots & turnips	Domesticated Plant Khouri et al. 2016
Digitaria exilis	Fonio	Domesticated Plant Khouri et al. 2016
Dioscorea alata	Purple Yam (Ube)	Domesticated Plant Khouri et al. 2016
Dioscorea cayenensis	Guinea Yam	Domesticated Plant Khouri et al. 2016
Dioscorea rotundata	West African Yam	Domesticated Plant Khouri et al. 2016
Diospyros kaki	Persimmons	Domesticated Plant Khouri et al. 2016
Echinochloa esculenta	Japanese millet	Domesticated Plant Khouri et al. 2016
Echinochloa frumentacea	Barnyard millets	Domesticated Plant Khouri et al. 2016
Echinochloa stagnina	Burgu millet	Domesticated Plant Khouri et al. 2016
Elaeis guineensis	Palm oil	Domesticated Plant Khouri et al. 2016
Elaeis oleifera	Palm oil	Domesticated Plant Khouri et al. 2016
Elettaria cardamomum	Cardamom	Domesticated Plant Khouri et al. 2016
Fagopyrum esculentum	Buckwheat	Domesticated Plant Khouri et al. 2016
Ficus carica	Figs	Domesticated Plant Khouri et al. 2016
Foeniculum vulgare	Fennel	Domesticated Plant Khouri et al. 2016
Foxtail millet	Setaria italica	Domesticated Plant Khouri et al. 2016
Fragaria × ananassa	Strawberries	Domesticated Plant Khouri et al. 2016
Garcinia mangostana	Mangosteens	Domesticated Plant Khouri et al. 2016
Glycine max	Soybean	Domesticated Plant Khouri et al. 2016
Gossypium arboreum	Tree cotton	Domesticated Plant Khouri et al. 2016
Gossypium barbadense	Creole cotton	Domesticated Plant Khouri et al. 2016
Gossypium herbaceum	Levant cotton	Domesticated Plant Khouri et al. 2016
Gossypium hirsutum	Upland cotton	Domesticated Plant Khouri et al. 2016
Helianthus annuus	Sunflower	Domesticated Plant Khouri et al. 2016
Hordeum vulgare L.	Barley	Domesticated Plant Khouri et al. 2016
Humulus lupulus	Hops	Domesticated Plant Khouri et al. 2016
Ilex paraguariensis	Mate	Domesticated Plant Khouri et al. 2016
Illicium verum	Badia	Domesticated Plant Khouri et al. 2016
Ipomoea batatas	Sweet potatoes	Domesticated Plant Khouri et al. 2016
Juglans regia	Walnuts	Domesticated Plant Khouri et al. 2016
Lactuca sativa	Lettuce	Domesticated Plant Khouri et al. 2016
Lens culinaris	Lentils	Domesticated Plant Khouri et al. 2016
Linum usitatissimum	Linseed	Domesticated Plant Khouri et al. 2016
Lupinus	Lupins	Domesticated Plant Khouri et al. 2016
Malus domestica	Apples	Domesticated Plant Khouri et al. 2016
Mangifera indica	Mangoes	Domesticated Plant Khouri et al. 2016
Manihot esculenta	Cassava	Domesticated Plant Khouri et al. 2016
Medicago sativa	Alfalfa	Domesticated Plant Khouri et al. 2016
Mentha × piperita	Peppermint	Domesticated Plant Khouri et al. 2016
Musa × paradisiaca	Banana Plantain hybrid	Domesticated Plant Khouri et al. 2016
Musa acuminata	Banana	Domesticated Plant Khouri et al. 2016
Musa balbisiana	Plantain	Domesticated Plant Khouri et al. 2016
Myristica fragrans	Nutmeg, mace	Domesticated Plant Khouri et al. 2016
Olea europaea	Olives	Domesticated Plant Khouri et al. 2016
Oryza glaberrima	African rice	Domesticated Plant Khouri et al. 2016
Oryza sativa L.,  Steud.	Rice	Domesticated Plant Khouri et al. 2016
Papaver somniferum	Opium Poppy	Domesticated Plant Khouri et al. 2016
Pennisetum glaucum	Eleusine coracana	Domesticated Plant Khouri et al. 2016
Persea americana	Avocados	Domesticated Plant Khouri et al. 2016
Phaseolus	Beans	Domesticated Plant Khouri et al. 2016
Phoenix dactylifera	Date palm	Domesticated Plant Khouri et al. 2016
Pimenta dioica	Pimento	Domesticated Plant Khouri et al. 2016
Pimpinella anisum	Anise	Domesticated Plant Khouri et al. 2016
Piper nigrum	Pepper	Domesticated Plant Khouri et al. 2016
Pistacia vera	Pistachios	Domesticated Plant Khouri et al. 2016
Pisum sativum	Peas	Domesticated Plant Khouri et al. 2016
Proso millet	Panicum mileaceum	Domesticated Plant Khouri et al. 2016
Prunus armeniaca	Apricots	Domesticated Plant Khouri et al. 2016
Prunus avium	Cherries	Domesticated Plant Khouri et al. 2016
Prunus domestica	Plums	Domesticated Plant Khouri et al. 2016
Prunus dulcis	Almonds	Domesticated Plant Khouri et al. 2016
Prunus persica	Peaches & nectarines	Domesticated Plant Khouri et al. 2016
Prunus salicina	Japanese plum	Domesticated Plant Khouri et al. 2016
Psidium guajava	Guavas	Domesticated Plant Khouri et al. 2016
Pyrus communis	European pear	Domesticated Plant Khouri et al. 2016
Pyrus pyrifolia	Nashi pear	Domesticated Plant Khouri et al. 2016
Ribes nigrum	Black current	Domesticated Plant Khouri et al. 2016
Ribes rubrum	Red current	Domesticated Plant Khouri et al. 2016
Ribes uva-crispa	Gooseberries	Domesticated Plant Khouri et al. 2016
Ricinus communis	Castor oil	Domesticated Plant Khouri et al. 2016
Rubus idaeus	Raspberries	Domesticated Plant Khouri et al. 2016
Saccharum officinarum	Sugarcane	Domesticated Plant Khouri et al. 2016
Secale cereale	Rye	Domesticated Plant Khouri et al. 2016
Sesamum indicum	Sesame	Domesticated Plant Khouri et al. 2016
Solanum lycopersicum	Tomatoes	Domesticated Plant Khouri et al. 2016
Solanum melongena	Eggplants	Domesticated Plant Khouri et al. 2016
Solanum tuberosum	Potatoes	Domesticated Plant Khouri et al. 2016
Sorghum bicolor	Sorghum	Domesticated Plant Khouri et al. 2016
Spinacia oleracea	Spinach	Domesticated Plant Khouri et al. 2016
Syzygium aromaticum	Cloves	Domesticated Plant Khouri et al. 2016
Teff	Eragrostis tef	Domesticated Plant Khouri et al. 2016
Theobroma cacao	Cocoa beans	Domesticated Plant Khouri et al. 2016
Trifolium pratense	Red clover	Domesticated Plant Khouri et al. 2016
Trifolium repens	White clover	Domesticated Plant Khouri et al. 2016
Triticum	Wheat	Domesticated Plant Khouri et al. 2016
Vaccinium	Blueberries and others	Domesticated Plant Khouri et al. 2016
Vaccinium corymbosum	Blueberries	Domesticated Plant Khouri et al. 2016
Vaccinium macrocarpon	Cranberries	Domesticated Plant Khouri et al. 2016
Vaccinium oxycoccos	Cranberries	Domesticated Plant Khouri et al. 2016
Vanilla	Vanilla	Domesticated Plant Khouri et al. 2016
Vicia	Vetches	Domesticated Plant Khouri et al. 2016
Vicia faba	Faba beans	Domesticated Plant Khouri et al. 2016
Vigna angularis	Adzuki bean	Domesticated Plant Khouri et al. 2016
Vigna radiata	Mung bean	Domesticated Plant Khouri et al. 2016
Vigna subterranea	Bambara beans	Domesticated Plant Khouri et al. 2016
Vigna unguiculata	Cowpeas	Domesticated Plant Khouri et al. 2016
Vitellaria paradoxa	Sheanuts	Domesticated Plant Khouri et al. 2016
Vitis vinifera	Grapes	Domesticated Plant Khouri et al. 2016
Xanthosoma sagittifolium	American taro	Domesticated Plant Khouri et al. 2016
Xanthosoma violaceum	Yautia	Domesticated Plant Khouri et al. 2016
Zea mays	Maize	Domesticated Plant Khouri et al. 2016
Zingiber officinale	Ginger	Domesticated Plant Khouri et al. 2016
Anadara granosa	Blood cockle	Domesticated Aquaculture FAO
Apostichopus	Japanese sea cucumber	Domesticated Aquaculture FAO
Carassius spp.	Crucian carp	Domesticated Aquaculture FAO
Catla catla	Catla	Domesticated Aquaculture FAO
Channa argus	Snakehead	Domesticated Aquaculture FAO
Chanos chanos	Milkfish	Domesticated Aquaculture FAO
Clarias spp	Torpedo-shaped catfishes nei	Domesticated Aquaculture FAO
Crassostrea gigas	Pacific cupped oyster	Domesticated Aquaculture FAO
Ctenopharyngodon idellus	Grass carp	Domesticated Aquaculture FAO
Cyprinus carpio	Common carp	Domesticated Aquaculture FAO
Eriocheir sinensis	Chinese mitten crab	Domesticated Aquaculture FAO
Eucheuma	Eucheuma seaweeds nei	Domesticated Aquaculture FAO
Eucheuma denticulatum	Spiny eucheuma	Domesticated Aquaculture FAO
Gracilaria	Gracilaria seaweeds	Domesticated Aquaculture FAO
Hypophthalmichthys molitrix	Silver carp	Domesticated Aquaculture FAO
Hypophthalmichthys nobilis	Bighead carp	Domesticated Aquaculture FAO
Kappaphycus alvarezii	Elkhorn sea moss	Domesticated Aquaculture FAO
Labeo rohita	Roho labeo	Domesticated Aquaculture FAO
Laminaria japonica	Japanese kelp	Domesticated Aquaculture FAO
Macrobrachium nipponense	Oriental river prawn	Domesticated Aquaculture FAO
Macrobrachium rosenbergii	Giant river prawn	Domesticated Aquaculture FAO
Megalobrama amblycephala	Wuchang bream	Domesticated Aquaculture FAO
Mylopharyngodon piceus	Black carp	Domesticated Aquaculture FAO
Mytilus chilensis	Chilean mussel	Domesticated Aquaculture FAO
Oncorhynchus mykiss	Rainbow trout	Domesticated Aquaculture FAO
Oreochromis	Tilapias nei	Domesticated Aquaculture FAO
Oreochromis niloticus	Nile tilapia	Domesticated Aquaculture FAO
Pangasius spp	Pangas catfishes nei	Domesticated Aquaculture FAO
Penaeus monodon	Giant tiger prawn	Domesticated Aquaculture FAO
Penaeus vannamei	Whiteleg shrimp	Domesticated Aquaculture FAO
Porphyra tenera	Nori	Domesticated Aquaculture FAO
Procambarus clarkii	Red swamp crawfish	Domesticated Aquaculture FAO
Ruditapes philippinarum	Manila Clam	Domesticated Aquaculture FAO
Salmo salar	Atlantic salmon	Domesticated Aquaculture FAO
Sargassum fusiforme	Fusiform sargassum	Domesticated Aquaculture FAO
Sinonovacula constricta	Constricted tagelus	Domesticated Aquaculture FAO
Spirulina	Spirulina nei	Domesticated Aquaculture FAO
Trionyx sinensis	Chinese softshell turtle	Domesticated Aquaculture FAO
Undaria pinnatifida	Wakame	Domesticated Aquaculture FAO
Anas platyrhynchos	Domestic Duck	Domesticated Animal FAO
Anser anser	Greylag Goose	Domesticated Animal FAO
Anser cygnoides	Swan	Domesticated Animal FAO
Bos bubalis carabensis	Swamp buffalo	Domesticated Animal FAO
Bos frontalis	Mithun	Domesticated Animal FAO
Bos grunniens	Yak	Domesticated Animal FAO
Bos indicus	Zebu cattle	Domesticated Animal FAO
Bos javanicus	Bali cattle	Domesticated Animal FAO
Bos taurus	Taurine cattle	Domesticated Animal FAO
Bubalus bubalis	River buffalo	Domesticated Animal FAO
Cairina moschata	Muscovy Duck	Domesticated Animal FAO
Camelus bactrianus	Bactrian camel	Domesticated Animal FAO
Camelus dromedarius	Dromedary	Domesticated Animal FAO
Capra hircus	Goat	Domesticated Animal FAO
Equus asinus	Donkey	Domesticated Animal FAO
Equus caballus	Horse	Domesticated Animal FAO
Gallus domesticus	Chicken	Domesticated Animal FAO
Lama glama	Llama	Domesticated Animal FAO
Meleagris gallopavo	Turkey	Domesticated Animal FAO
Oryctolagus cuniculus	Rabbit	Domesticated Animal FAO
Ovis aries	Sheep	Domesticated Animal FAO
Rangifer tarandus	Reindeer	Domesticated Animal FAO
Sus scrofa	Pig	Domesticated Animal FAO
Vicugna pacos	Alpaca	Domesticated Animal FAO
Abelmoschus manihot	sunset muskmallow	Domesticated Plant GRIN Food
Abutilon theophrasti	c("velvetleaf", "butterprint", "buttonweed", "Indian mallow", "velvetleaf Indian mallow", "China jute", "Indian hemp", "pie-marker")	Domesticated Plant GRIN Food
Acacia saligna	orange wattle	Domesticated Plant GRIN Food
Acalypha wilkesiana	c("match me if you can", "Jacob's coat", "capa de obispo")	Domesticated Plant GRIN Food
Acca sellowiana	feijoa	Domesticated Plant GRIN Food
Acer saccharum	sugar maple	Domesticated Plant GRIN Food
Actinidia arguta	tara vine	Domesticated Plant GRIN Food
Actinidia chinensis	kiwi	Domesticated Plant GRIN Food
Adansonia digitata	baobab	Domesticated Plant GRIN Food
Aegle marmelos	Indian bael	Domesticated Plant GRIN Food
Afrocarpus falcatus	yellowwood	Domesticated Plant GRIN Food
Agave americana	c("American century plant", "American agave", "Maguey americano", "centuryplant")	Domesticated Plant GRIN Food
Agave angustifolia	c("century plant", "Maguey espadín")	Domesticated Plant GRIN Food
Agave atrovirens	c("maguey", "Maguey de montaña")	Domesticated Plant GRIN Food
Agave tequilana	c("tequila agave", "Mezcal azul tequilero")	Domesticated Plant GRIN Food
Agrimonia eupatoria	churchsteeples	Domesticated Plant GRIN Food
Aiphanes minima	Guinea bactris	Domesticated Plant GRIN Food
Alhagi maurorum	camelthorn	Domesticated Plant GRIN Food
Allium ampeloprasum	broadleaf wild leek	Domesticated Plant GRIN Food
Allium canadense	c("meadow onion", "ail du Canada", "wild onion", "Canada garlic", "meadow garlic")	Domesticated Plant GRIN Food
Allium chinense	rakkyo	Domesticated Plant GRIN Food
Allium fistulosum	welsh onion	Domesticated Plant GRIN Food
Allium tuberosum	Chinese chives	Domesticated Plant GRIN Food
Allium victorialis	victory onion	Domesticated Plant GRIN Food
Alocasia cucullata	chinese taro	Domesticated Plant GRIN Food
Alocasia macrorrhizos	giant taro	Domesticated Plant GRIN Food
Aloysia citrodora	lemon beebrush	Domesticated Plant GRIN Food
Alternanthera sessilis	sessile joyweed	Domesticated Plant GRIN Food
Althaea officinalis	c("common marsh-mallow", "common marshmallow", "guimauve officinale")	Domesticated Plant GRIN Food
Amaranthus blitum	purple amaranth	Domesticated Plant GRIN Food
Amaranthus caudatus	c("quelite", "love-lies-bleeding")	Domesticated Plant GRIN Food
Amaranthus cruentus	red amaranth	Domesticated Plant GRIN Food
Amaranthus dubius	spleen amaranth	Domesticated Plant GRIN Food
Amaranthus hypochondriacus	c("Prince-of-Wales-feather", "Prince-of-Wales feather")	Domesticated Plant GRIN Food
Amaranthus spinosus	c("pigweed", "spiny amaranth")	Domesticated Plant GRIN Food
Amaranthus tricolor	Joseph's-coat	Domesticated Plant GRIN Food
Amaranthus viridis	slender amaranth	Domesticated Plant GRIN Food
Amelanchier alnifolia	c("juneberry", "Pacific serviceberry", "western serviceberry", "western shadbush", "Saskatoon serviceberry")	Domesticated Plant GRIN Food
Amelanchier arborea	c("Allegheny serviceberry", "apple shadbush", "downy serviceberry", "shadblow", "common serviceberry")	Domesticated Plant GRIN Food
Amorphophallus konjac	devil's tongue	Domesticated Plant GRIN Food
Amorphophallus paeoniifolius	whitespot giant arum	Domesticated Plant GRIN Food
Amphicarpaea bracteata	c("American hogpeanut", "hog-peanut")	Domesticated Plant GRIN Food
Angelica archangelica	Norwegian angelica	Domesticated Plant GRIN Food
Annona cherimola	cherimoya	Domesticated Plant GRIN Food
Annona glabra	pond apple	Domesticated Plant GRIN Food
Annona montana	mountain soursop	Domesticated Plant GRIN Food
Annona muricata	soursop	Domesticated Plant GRIN Food
Annona reticulata	custard apple	Domesticated Plant GRIN Food
Annona squamosa	c("sweet sop", "sugar apple")	Domesticated Plant GRIN Food
Anredera cordifolia	c("Gulf madeiravine", "mignonette vine", "heartleaf madeiravine")	Domesticated Plant GRIN Food
Antidesma bunius	bignay	Domesticated Plant GRIN Food
Antidesma platyphyllum	ha'a	Domesticated Plant GRIN Food
Aphanes arvensis	field parsley piert	Domesticated Plant GRIN Food
Apios americana	c("groundnut", "potatobean")	Domesticated Plant GRIN Food
Apium graveolens	wild celery	Domesticated Plant GRIN Food
Aponogeton distachyos	Cape pondweed	Domesticated Plant GRIN Food
Arachis villosulicarpa	groundnut	Domesticated Plant GRIN Food
Aralia cordata	udo	Domesticated Plant GRIN Food
Aralia elata	Japanese angelica tree	Domesticated Plant GRIN Food
Araucaria angustifolia	Parana pine	Domesticated Plant GRIN Food
Araucaria araucana	c("monkeypuzzle tree", "monkey puzzle tree")	Domesticated Plant GRIN Food
Araucaria bidwillii	bunya bunya	Domesticated Plant GRIN Food
Arbutus unedo	strawberry tree	Domesticated Plant GRIN Food
Arctium lappa	c("greater burdock", "woodland burdock", "bardane", "great burdock", "greater burrdock")	Domesticated Plant GRIN Food
Arenaria serpyllifolia	thymeleaf sandwort	Domesticated Plant GRIN Food
Arenga pinnata	sugar palm	Domesticated Plant GRIN Food
Aronia melanocarpa	black chokeberry	Domesticated Plant GRIN Food
Arracacia xanthorrhiza	arracacha	Domesticated Plant GRIN Food
Artemisia scoparia	redstem wormwood	Domesticated Plant GRIN Food
Arthropodium cirrhatum	rock-lily	Domesticated Plant GRIN Food
Artocarpus altilis	breadfruit	Domesticated Plant GRIN Food
Artocarpus heterophyllus	jackfruit	Domesticated Plant GRIN Food
Artocarpus integer	chempedak	Domesticated Plant GRIN Food
Artocarpus odoratissimus	marang	Domesticated Plant GRIN Food
Artocarpus rigidus	monkey Jack	Domesticated Plant GRIN Food
Asimina triloba	pawpaw	Domesticated Plant GRIN Food
Aspalathus linearis	rooibos	Domesticated Plant GRIN Food
Asparagus africanus	African asparagus	Domesticated Plant GRIN Food
Atriplex halimus	saltbush	Domesticated Plant GRIN Food
Atriplex hortensis	c("garden orach", "garden orache", "mountain-spinach", "bledos moles", "armuelle mole")	Domesticated Plant GRIN Food
Attalea cohune	c("cohune palm", "Corozo cohune")	Domesticated Plant GRIN Food
Attalea funifera	Bahia piassaba palm	Domesticated Plant GRIN Food
Avena abyssinica	Abyssinian oat	Domesticated Plant GRIN Food
Avena nuda	naked oat	Domesticated Plant GRIN Food
Averrhoa bilimbi	bilimbi	Domesticated Plant GRIN Food
Averrhoa carambola	carambola	Domesticated Plant GRIN Food
Baccaurea motleyana	rambai	Domesticated Plant GRIN Food
Baccaurea racemosa	menteng	Domesticated Plant GRIN Food
Bactris gasipaes	peach palm	Domesticated Plant GRIN Food
Baillonella toxisperma	djave	Domesticated Plant GRIN Food
Balanites aegyptiaca	desert date	Domesticated Plant GRIN Food
Balanites maughamii	manduro	Domesticated Plant GRIN Food
Bambusa bambos	thorny bamboo	Domesticated Plant GRIN Food
Bambusa beecheyana	Beechey's bamboo	Domesticated Plant GRIN Food
Bambusa tulda	bamboo	Domesticated Plant GRIN Food
Bambusa tuldoides	puntingpole bamboo	Domesticated Plant GRIN Food
Barbarea verna	early yellowrocket	Domesticated Plant GRIN Food
Barbarea vulgaris	c("yellow rocket", "garden yellow rocket", "winter cress", "garden yellowrocket")	Domesticated Plant GRIN Food
Barleria opaca	kwahu	Domesticated Plant GRIN Food
Basella alba	Ceylon spinach	Domesticated Plant GRIN Food
Bassia scoparia	c("burningbush", "Mexican fireweed", "mock cypress", "kochia")	Domesticated Plant GRIN Food
Begonia cucullata	clubed begonia	Domesticated Plant GRIN Food
Benincasa hispida	waxgourd	Domesticated Plant GRIN Food
Bidens pilosa	c("hairy beggarticks", "common beggarticks", "romerillo", "spanish-needles", "beggar's ticks", "cobbler's pegs", "fisi`uli", "kofe tonga", "matakaro", "Spanish needles")	Domesticated Plant GRIN Food
Bistorta officinalis	meadow bistort	Domesticated Plant GRIN Food
Blighia sapida	akee	Domesticated Plant GRIN Food
Blumea lacera	blumea	Domesticated Plant GRIN Food
Borago officinalis	common borage	Domesticated Plant GRIN Food
Borassus aethiopum	palmyra palm	Domesticated Plant GRIN Food
Borassus flabellifer	toddy palm	Domesticated Plant GRIN Food
Boscia senegalensis	Senegal boscia	Domesticated Plant GRIN Food
Boswellia serrata	Indian frankincense	Domesticated Plant GRIN Food
Brasenia schreberi	c("Schreber's watershield", "watershield")	Domesticated Plant GRIN Food
Brassica carinata	Abyssinian mustard	Domesticated Plant GRIN Food
Brassica cretica	mustard	Domesticated Plant GRIN Food
Bromus mango	mango brome	Domesticated Plant GRIN Food
Brosimum alicastrum	breadnut	Domesticated Plant GRIN Food
Buchanania latifolia	chirauli nut	Domesticated Plant GRIN Food
Bunchosia nitida	woodland coffee	Domesticated Plant GRIN Food
Bunias orientalis	Turkish wartycabbage	Domesticated Plant GRIN Food
Bunium bulbocastanum	c("great pignut", "earth-nut")	Domesticated Plant GRIN Food
Butia capitata	South American jelly palm	Domesticated Plant GRIN Food
Byrsonima crassifolia	maricao cimun	Domesticated Plant GRIN Food
Byrsonima spicata	c("doncella", "Maricao cimarron")	Domesticated Plant GRIN Food
Calamus rotang	rattan	Domesticated Plant GRIN Food
Caltha palustris	c("yellow marsh-marigold", "yellow marshmarigold", "yellow marsh marigold")	Domesticated Plant GRIN Food
Camassia quamash	c("common camas", "small camas")	Domesticated Plant GRIN Food
Camelina sativa	gold-of-pleasure	Domesticated Plant GRIN Food
Camellia reticulata	to-tsubaki	Domesticated Plant GRIN Food
Canarium album	Chinese white olive	Domesticated Plant GRIN Food
Canarium indicum	Java almond	Domesticated Plant GRIN Food
Canarium ovatum	pili nut	Domesticated Plant GRIN Food
Canarium pimela	Chinese black olive	Domesticated Plant GRIN Food
Canavalia ensiformis	c("wonderbean", "wonder-bean")	Domesticated Plant GRIN Food
Canavalia gladiata	sword jackbean	Domesticated Plant GRIN Food
Canna glauca	maraca amarilla	Domesticated Plant GRIN Food
Canna indica	Indian shot	Domesticated Plant GRIN Food
Capparis spinosa	caper	Domesticated Plant GRIN Food
Capraria biflora	goatweed	Domesticated Plant GRIN Food
Capsella bursa	c("shepherdspurse", "shepherd's-purse")	Domesticated Plant GRIN Food
Capsicum pubescens	rocoto	Domesticated Plant GRIN Food
Carissa carandas	karanda	Domesticated Plant GRIN Food
Carissa macrocarpa	amatungulu	Domesticated Plant GRIN Food
Carnegiea gigantea	c("Saguaro", "saguaro")	Domesticated Plant GRIN Food
Carpobrotus edulis	c("freeway iceplant", "Hottentot-fig")	Domesticated Plant GRIN Food
Carya illinoinensis	c("nuez encarcelada", "nogal morado", "pecanier", "pecan")	Domesticated Plant GRIN Food
Carya ovata	c("shagbark hickory", "caryer ovale", "noyer tendre", "shellbark hickory")	Domesticated Plant GRIN Food
Caryocar amygdaliferum	achotillo	Domesticated Plant GRIN Food
Caryocar brasiliense	pequi	Domesticated Plant GRIN Food
Caryocar nuciferum	souari nut	Domesticated Plant GRIN Food
Caryota urens	jaggery palm	Domesticated Plant GRIN Food
Casimiroa edulis	white sapote	Domesticated Plant GRIN Food
Casimiroa tetrameria	matasano	Domesticated Plant GRIN Food
Castanea crenata	Japanese chestnut	Domesticated Plant GRIN Food
Castanea mollissima	Chinese chestnut	Domesticated Plant GRIN Food
Castanea pumila	c("chinkapin", "Allegheny chinkapin", "northern catalpa")	Domesticated Plant GRIN Food
Catha edulis	khat	Domesticated Plant GRIN Food
Caulophyllum thalictroides	c("caulophylle faux-pigamon", "papoose-root", "squaw-root", "blue cohosh")	Domesticated Plant GRIN Food
Ceanothus americanus	c("céanothe d'Amérique", "Jersey tea", "New Jersey tea")	Domesticated Plant GRIN Food
Celosia argentea	silver cock's comb	Domesticated Plant GRIN Food
Centella asiatica	spadeleaf	Domesticated Plant GRIN Food
Cephalaria syriaca	Syrian cephalaria	Domesticated Plant GRIN Food
Ceratopteris thalictroides	watersprite	Domesticated Plant GRIN Food
Ceratotheca sesamoides	false sesame	Domesticated Plant GRIN Food
Chaenomeles japonica	c("Japanese flowering quince", "Maule's quince")	Domesticated Plant GRIN Food
Chaenomeles speciosa	flowering quince	Domesticated Plant GRIN Food
Chaerophyllum bulbosum	c("turniproot chervil", "turnip-root chervil")	Domesticated Plant GRIN Food
Chamaemelum nobile	Roman chamomile	Domesticated Plant GRIN Food
Chenopodium album	c("common lambsquarters", "lambsquarters goosefoot", "white goosefoot", "lambsquarters")	Domesticated Plant GRIN Food
Chenopodium berlandieri	c("pit-seed goosefoot", "netseed lambsquarters", "pigseed goosefoot", "pitseed goosefoot")	Domesticated Plant GRIN Food
Chenopodium pallidicaule	canihua	Domesticated Plant GRIN Food
Chorispora tenella	c("purple mustard", "tenella mustard", "bluemustard", "common blue mustard", "beanpodded mustard", "blue mustard", "crossflower")	Domesticated Plant GRIN Food
Chrysobalanus icaco	c("icaco coco plum", "icaco", "coco plum")	Domesticated Plant GRIN Food
Chrysophyllum albidum	white star apple	Domesticated Plant GRIN Food
Chrysophyllum cainito	star apple	Domesticated Plant GRIN Food
Chrysophyllum oliviforme	c("saffron-tree", "damson-plum", "satinleaf")	Domesticated Plant GRIN Food
Cichorium endivia	cultivated endive	Domesticated Plant GRIN Food
Cissus quadrangularis	veldt-grape	Domesticated Plant GRIN Food
Citrus maxima	c("shaddock", "pomelo", "pummelo")	Domesticated Plant GRIN Food
Citrus medica	citron	Domesticated Plant GRIN Food
Citrus reticulata	tangerine	Domesticated Plant GRIN Food
Clausena lansium	wampi	Domesticated Plant GRIN Food
Claytonia perfoliata	c("minerslettuce", "miner's lettuce")	Domesticated Plant GRIN Food
Clidemia hirta	c("kaurasiga", "Koster's curse", "kui", "mbona na mbulamakau", "roinisinga", "soap bush", "soapbush")	Domesticated Plant GRIN Food
Clinopodium nepeta	lesser calamint	Domesticated Plant GRIN Food
Cnidoscolus aconitifolius	treadsoftly	Domesticated Plant GRIN Food
Coccinia grandis	c("scarlet-fruited gourd", "ivy gourd")	Domesticated Plant GRIN Food
Coccoloba uvifera	seagrape	Domesticated Plant GRIN Food
Coffea liberica	Liberian coffee	Domesticated Plant GRIN Food
Cola nitida	ghanja kola	Domesticated Plant GRIN Food
Cola verticillata	cola	Domesticated Plant GRIN Food
Colubrina elliptica	soldierwood	Domesticated Plant GRIN Food
Conringia orientalis	c("hare's-ear-mustard", "haresear mustard", "treacle haresear", "hare's ear mustard")	Domesticated Plant GRIN Food
Corchorus olitorius	nalta jute	Domesticated Plant GRIN Food
Corchorus trilocularis	threelocule corchorus	Domesticated Plant GRIN Food
Cordia dichotoma	fragrant manjack	Domesticated Plant GRIN Food
Cordia myxa	Assyrian plum	Domesticated Plant GRIN Food
Cordyline fruticosa	tiplant	Domesticated Plant GRIN Food
Cornus capitata	Bentham's cornel	Domesticated Plant GRIN Food
Cornus kousa	c("kousa dogwood", "Japanese dogwood", "kousa")	Domesticated Plant GRIN Food
Cornus mas	c("Cornelian cherry", "sorbet", "cornejo macho")	Domesticated Plant GRIN Food
Corylus colurna	Turkish hazelnut	Domesticated Plant GRIN Food
Corylus heterophylla	Siberian hazelnut	Domesticated Plant GRIN Food
Cosmos caudatus	wild cosmos	Domesticated Plant GRIN Food
Crambe maritima	sea kale	Domesticated Plant GRIN Food
Craniolaria annua	escorzonera	Domesticated Plant GRIN Food
Crassocephalum crepidioides	redflower ragleaf	Domesticated Plant GRIN Food
Crataegus aestivalis	may hawthorn	Domesticated Plant GRIN Food
Crataegus azarolus	c("azarole", "Mediterranean-medlar")	Domesticated Plant GRIN Food
Crataegus crus	c("aubépine ergot-de-coq", "bush hawthorn", "cockspur hawthorn")	Domesticated Plant GRIN Food
Crataegus douglasii	c("river hawthorn", "black hawthorn")	Domesticated Plant GRIN Food
Crataegus mexicana	c("tejocote", "Mexican hawthorn", "manzanita tejocotera")	Domesticated Plant GRIN Food
Crataegus opaca	c("riverflat hawthorn", "western mayhaw", "apple haw")	Domesticated Plant GRIN Food
Crataegus pinnatifida	c("Chinese haw", "Chinese hawthorn")	Domesticated Plant GRIN Food
Crataegus rufula	rusty hawthorn	Domesticated Plant GRIN Food
Crescentia cujete	common calabash tree	Domesticated Plant GRIN Food
Crotalaria cajanifolia	c("chipilín", "chipilín de zope", "chipilín montés")	Domesticated Plant GRIN Food
Crotalaria longirostrata	longbeak rattlebox	Domesticated Plant GRIN Food
Cryptotaenia canadensis	c("honewort", "Canadian honewort")	Domesticated Plant GRIN Food
Cryptotaenia japonica	Japanese honewort	Domesticated Plant GRIN Food
Cucumis anguria	West Indian gherkin	Domesticated Plant GRIN Food
Cucumis ficifolius	cucumis	Domesticated Plant GRIN Food
Cucumis metuliferus	African horned cucumber	Domesticated Plant GRIN Food
Cucurbita ficifolia	figleaf gourd	Domesticated Plant GRIN Food
Cucurbita foetidissima	c("calabazilla", "wild gourd", "wild pumkin", "buffalo gourd", "buffalogourd pumpkin", "Missouri gourd")	Domesticated Plant GRIN Food
Cuphea viscosissima	blue waxweed	Domesticated Plant GRIN Food
Curcuma amada	mango ginger	Domesticated Plant GRIN Food
Curcuma angustifolia	East Indian arrowroot	Domesticated Plant GRIN Food
Cyanthillium cinereum	little ironweed	Domesticated Plant GRIN Food
Cycas revoluta	sago palm	Domesticated Plant GRIN Food
Cyclanthera pedata	cyclanthera	Domesticated Plant GRIN Food
Cyperus compressus	poorland flatsedge	Domesticated Plant GRIN Food
Cyperus esculentus	c("chufa flatsedge", "chufa", "yellow nutgrass", "yellow nutsedge")	Domesticated Plant GRIN Food
Cyperus rotundus	c("chaguan humatag", "cocograss", "kili'o'opu", "pakopako", "purple nutsedge", "nutgrass")	Domesticated Plant GRIN Food
Cyrtosperma merkusii	gallan	Domesticated Plant GRIN Food
Dacryodes edulis	eben tree	Domesticated Plant GRIN Food
Dendrocalamus asper	giant bamboo	Domesticated Plant GRIN Food
Dendrocalamus latiflorus	giant bamboo	Domesticated Plant GRIN Food
Dendrocalamus strictus	male bamboo	Domesticated Plant GRIN Food
Descurainia sophia	c("flixweed", "pinnate tansymustard", "flaxweed tansymustard", "flixweed tansymustard", "herb-sophia", "tansymustard", "herb sophia")	Domesticated Plant GRIN Food
Dialium guineense	velvet tamarind	Domesticated Plant GRIN Food
Digera muricata	false amaranth	Domesticated Plant GRIN Food
Digitaria iburua	black fonio	Domesticated Plant GRIN Food
Dillenia ovata	ovate dillenia	Domesticated Plant GRIN Food
Dillenia philippinensis	Philippine dillenia	Domesticated Plant GRIN Food
Dimocarpus longan	longan	Domesticated Plant GRIN Food
Dioscorea bulbifera	c("air potato", "bitter yam", "air yam")	Domesticated Plant GRIN Food
Dioscorea convolvulacea	yam	Domesticated Plant GRIN Food
Dioscorea dumetorum	bitter yam	Domesticated Plant GRIN Food
Dioscorea esculenta	lesser yam	Domesticated Plant GRIN Food
Dioscorea hispida	intoxicating yam	Domesticated Plant GRIN Food
Dioscorea japonica	Japanese yam	Domesticated Plant GRIN Food
Dioscorea pentaphylla	fiveleaf yam	Domesticated Plant GRIN Food
Dioscorea polystachya	Chinese yam	Domesticated Plant GRIN Food
Dioscorea praehensilis	bush yam	Domesticated Plant GRIN Food
Dioscorea trifida	Indian yam	Domesticated Plant GRIN Food
Diospyros blancoi	mabolo	Domesticated Plant GRIN Food
Diospyros digyna	black sapote	Domesticated Plant GRIN Food
Diospyros lotus	date plum	Domesticated Plant GRIN Food
Diospyros texana	Texas persimmon	Domesticated Plant GRIN Food
Diospyros virginiana	c("eastern persimmon", "common persimmon")	Domesticated Plant GRIN Food
Diplazium esculentum	vegetable fern	Domesticated Plant GRIN Food
Diplotaxis muralis	annual wallrocket	Domesticated Plant GRIN Food
Dipogon lignosus	Okie bean	Domesticated Plant GRIN Food
Dorstenia contrajerva	tusilla	Domesticated Plant GRIN Food
Dovyalis abyssinica	koshum	Domesticated Plant GRIN Food
Dovyalis caffra	kei apple	Domesticated Plant GRIN Food
Dovyalis hebecarpa	Ceylon gooseberry	Domesticated Plant GRIN Food
Dracontomelon dao	Argus pheasant tree	Domesticated Plant GRIN Food
Durio zibethinus	durian	Domesticated Plant GRIN Food
Dyera costulata	jelutong	Domesticated Plant GRIN Food
Echinocereus stramineus	c("Órgano-pequeño sanjuanero", "strawberry hedgehog cactus")	Domesticated Plant GRIN Food
Echinochloa oryzicola	rice barnyardgrass	Domesticated Plant GRIN Food
Echium plantagineum	salvation jane	Domesticated Plant GRIN Food
Elaeagnus angustifolia	c("Russian olive", "Russian-olive", "Trebizond-date", "oleaster")	Domesticated Plant GRIN Food
Eleocharis dulcis	c("Chinese water chestnut", "Chinese waterchestnut")	Domesticated Plant GRIN Food
Eleusine coracana	finger millet	Domesticated Plant GRIN Food
Emilia sonchifolia	lilac tasselflower	Domesticated Plant GRIN Food
Ensete ventricosum	Abyssinian banana	Domesticated Plant GRIN Food
Entada gigas	nicker bean	Domesticated Plant GRIN Food
Entada phaseoloides	St. Thomas bean	Domesticated Plant GRIN Food
Epiphyllum oxypetalum	c("Nopalillo criollo", "Dutchman's pipe cactus")	Domesticated Plant GRIN Food
Eragrostis tef	teff	Domesticated Plant GRIN Food
Erechtites hieraciifolius	c("American burnweed", "burnweed")	Domesticated Plant GRIN Food
Eriobotrya japonica	loquat	Domesticated Plant GRIN Food
Eriogonum davidsonii	c("Davidson's buckwheat", "Davidson's wild buckwheat")	Domesticated Plant GRIN Food
Eruca vesicaria	c("rocket-salad", "rocketsalad")	Domesticated Plant GRIN Food
Erythrina berteroana	machete	Domesticated Plant GRIN Food
Erythrina fusca	c("bucayo", "lucky beantree", "Cape Kaffirboom", "Kaffirboom")	Domesticated Plant GRIN Food
Eugeissona utilis	kadjatoa	Domesticated Plant GRIN Food
Eugenia brasiliensis	grumichama	Domesticated Plant GRIN Food
Eugenia uniflora	c("pitanga", "Suriname cherry")	Domesticated Plant GRIN Food
Euterpe oleracea	Assai palm	Domesticated Plant GRIN Food
Fagopyrum tataricum	c("green buckwheat", "Japanese buckwheat", "Tartary buckwheat")	Domesticated Plant GRIN Food
Falcaria vulgaris	sickleweed	Domesticated Plant GRIN Food
Fernaldia pandurata	loroco	Domesticated Plant GRIN Food
Ficus auriculata	Roxburgh fig	Domesticated Plant GRIN Food
Ficus palmata	Punjab fig	Domesticated Plant GRIN Food
Ficus pumila	climbingfig	Domesticated Plant GRIN Food
Ficus sycomorus	sycamore fig	Domesticated Plant GRIN Food
Flacourtia indica	governor's plum	Domesticated Plant GRIN Food
Flacourtia inermis	batoko plum	Domesticated Plant GRIN Food
Flacourtia jangomas	Indian plum	Domesticated Plant GRIN Food
Flacourtia rukam	rukam	Domesticated Plant GRIN Food
Fragaria chiloensis	beach strawberry	Domesticated Plant GRIN Food
Fragaria vesca	woodland strawberry	Domesticated Plant GRIN Food
Fragaria virginiana	c("thickleaved wild strawberry", "wild strawberry", "Virginia strawberry")	Domesticated Plant GRIN Food
Frangula caroliniana	Carolina buckthorn	Domesticated Plant GRIN Food
Fritillaria camschatcensis	Kamchatka fritillary	Domesticated Plant GRIN Food
Garcinia dulcis	gourka	Domesticated Plant GRIN Food
Garcinia indica	garcinia	Domesticated Plant GRIN Food
Garcinia livingstonei	Livingstone's garcinia	Domesticated Plant GRIN Food
Garcinia multiflora	garcinia	Domesticated Plant GRIN Food
Garcinia xanthochymus	garcinia	Domesticated Plant GRIN Food
Gaultheria shallon	c("shallal", "salal")	Domesticated Plant GRIN Food
Gaylussacia baccata	black huckleberry	Domesticated Plant GRIN Food
Gaylussacia frondosa	c("blue huckleberry", "dangleberry")	Domesticated Plant GRIN Food
Genipa americana	jagua	Domesticated Plant GRIN Food
Ginkgo biloba	c("maidenhair tree", "common ginkgo")	Domesticated Plant GRIN Food
Glebionis segetum	corndaisy	Domesticated Plant GRIN Food
Glyceria fluitans	water mannagrass	Domesticated Plant GRIN Food
Gnetum africanum	African jointfir	Domesticated Plant GRIN Food
Gnetum buchholzianum	jointfir	Domesticated Plant GRIN Food
Gnetum gnemon	buko	Domesticated Plant GRIN Food
Grewia asiatica	phalsa	Domesticated Plant GRIN Food
Grewia occidentalis	crossberry	Domesticated Plant GRIN Food
Guizotia abyssinica	ramtilla	Domesticated Plant GRIN Food
Gundelia tournefortii	Tournefort's gundelia	Domesticated Plant GRIN Food
Gynandropsis gynandra	spiderwisp	Domesticated Plant GRIN Food
Hancornia speciosa	mangabeira	Domesticated Plant GRIN Food
Helianthus tuberosus	c("Jerusalem artichoke", "girasole", "Jerusalem sunflower", "Jerusalem-artichoke")	Domesticated Plant GRIN Food
Hemerocallis citrina	c("citron daylily", "long yellow daylily")	Domesticated Plant GRIN Food
Hemerocallis lilioasphodelus	c("yellow daylily", "lemon lily", "lemon daylily")	Domesticated Plant GRIN Food
Hemerocallis minor	small daylily	Domesticated Plant GRIN Food
Hesperis matronalis	c("dame's rocket", "dames violet", "mother-of-the-evening", "dames rocket")	Domesticated Plant GRIN Food
Hibiscus acetosella	c("African rosemallow", "red-leaf hibiscus", "cranberry hibiscus", "African rose-mallow", "false roselle")	Domesticated Plant GRIN Food
Hibiscus radiatus	c("monarch rosemallow", "monarch rose-mallow")	Domesticated Plant GRIN Food
Hibiscus sabdariffa	roselle	Domesticated Plant GRIN Food
Hippophae rhamnoides	c("seaberry", "seabuckthorn")	Domesticated Plant GRIN Food
Hordeum vulgare	c("common barley", "barley", "cereal barley")	Domesticated Plant GRIN Food
Houttuynia cordata	chameleon	Domesticated Plant GRIN Food
Hovenia dulcis	Japanese raisintree	Domesticated Plant GRIN Food
Hymenaea courbaril	stinkingtoe	Domesticated Plant GRIN Food
Hyphaene thebaica	doum palm	Domesticated Plant GRIN Food
Icacina oliviformis	false yam	Domesticated Plant GRIN Food
Inga edulis	icecreambean	Domesticated Plant GRIN Food
Ipomoea aquatica	c("swamp morningglory", "water spinach", "Chinese waterspinach", "swamp morning-glory")	Domesticated Plant GRIN Food
Ipomoea eriocarpa	morningglory	Domesticated Plant GRIN Food
Ipomoea littoralis	c("whiteflower beach morningglory", "whiteflower beach morning-glory")	Domesticated Plant GRIN Food
Jaltomata procumbens	creeping false holly	Domesticated Plant GRIN Food
Jarilla heterophylla	jarilla	Domesticated Plant GRIN Food
Jubaea chilensis	Chile cocopalm	Domesticated Plant GRIN Food
Juglans ailantifolia	Japanese walnut	Domesticated Plant GRIN Food
Juglans cinerea	c("noyer cendré", "white walnut", "butternut")	Domesticated Plant GRIN Food
Juglans hindsii	c("Hinds's black walnut", "Northern California walnut")	Domesticated Plant GRIN Food
Juglans mandshurica	Manchurian walnut	Domesticated Plant GRIN Food
Juglans neotropica	Andean walnut	Domesticated Plant GRIN Food
Juglans nigra	c("black walnut", "noyer noir")	Domesticated Plant GRIN Food
Kaempferia galanga	galanga	Domesticated Plant GRIN Food
Lablab purpureus	hyacinthbean	Domesticated Plant GRIN Food
Lactuca indica	Indian lettuce	Domesticated Plant GRIN Food
Lagenaria siceraria	bottle gourd	Domesticated Plant GRIN Food
Landolphia heudelotii	landolphia rubber	Domesticated Plant GRIN Food
Lansium domesticum	langsat	Domesticated Plant GRIN Food
Lathyrus ochrus	c("Cyprus-vetch", "ochrus-vetch", "alverjana", "tapisote")	Domesticated Plant GRIN Food
Lathyrus sativus	white pea	Domesticated Plant GRIN Food
Lathyrus tuberosus	c("tuberous sweetpea", "earth-nut pea")	Domesticated Plant GRIN Food
Lecythis minor	c("coco de mono", "lecythis")	Domesticated Plant GRIN Food
Lecythis zabucajo	c("monkeynut", "paradise nut")	Domesticated Plant GRIN Food
Lemna gibba	c("swollen duckweed", "inflated duckweed")	Domesticated Plant GRIN Food
Lepidium coronopus	greater swinecress	Domesticated Plant GRIN Food
Lepidium draba	c("whitetop", "hoary cress")	Domesticated Plant GRIN Food
Lepidium latifolium	c("perennial pepperweed", "broadleaved peppergrass", "tall whitetop", "Virginia pepperweed", "broadleaf pepperweed", "perennial peppercress", "peppergrass mustard", "broadleaved pepperweed")	Domesticated Plant GRIN Food
Lepidium meyenii	maca	Domesticated Plant GRIN Food
Lepidium sativum	c("garden pepperwort", "gardencress pepperweed")	Domesticated Plant GRIN Food
Lilium lancifolium	tiger lily	Domesticated Plant GRIN Food
Limnocharis flava	yellow velvetleaf	Domesticated Plant GRIN Food
Limonia acidissima	Indian woodapple	Domesticated Plant GRIN Food
Litchi chinensis	lychee	Domesticated Plant GRIN Food
Lonicera caerulea	c("sweetberry honeysuckle", "blue honeysuckle", "fly honeysuckle")	Domesticated Plant GRIN Food
Lotus tetragonolobus	winged pea	Domesticated Plant GRIN Food
Luffa acutangula	sinkwa towelsponge	Domesticated Plant GRIN Food
Luffa aegyptiaca	sponge gourd	Domesticated Plant GRIN Food
Lupinus albus	white lupine	Domesticated Plant GRIN Food
Lupinus angustifolius	c("narrowleaf lupine", "blue lupine", "altramuz azul")	Domesticated Plant GRIN Food
Lupinus mutabilis	tarwi	Domesticated Plant GRIN Food
Lycianthes asarifolia	gingerleaf	Domesticated Plant GRIN Food
Lycium barbarum	c("matrimony vine", "matrimonyvine", "matrimony-vine", "common matrimonyvine")	Domesticated Plant GRIN Food
Lycium chinense	Chinese desert-thorn	Domesticated Plant GRIN Food
Macadamia integrifolia	macadamia nut	Domesticated Plant GRIN Food
Macadamia tetraphylla	macadamia nut	Domesticated Plant GRIN Food
Macroptilium gibbosifolium	c("variableleaf bushbean", "wild bushbean")	Domesticated Plant GRIN Food
Macrotyloma geocarpum	geocarpa groundnut	Domesticated Plant GRIN Food
Macrotyloma uniflorum	horsegram	Domesticated Plant GRIN Food
Madhuca longifolia	mahua	Domesticated Plant GRIN Food
Madia sativa	c("coast tarweed", "Chilean tarweed", "tarweed")	Domesticated Plant GRIN Food
Malpighia emarginata	Barbados cherry	Domesticated Plant GRIN Food
Malus angustifolia	c("southern crabapple", "southern crab apple")	Domesticated Plant GRIN Food
Malus baccata	c("Siberian crabapple", "Siberian crab apple")	Domesticated Plant GRIN Food
Malus coronaria	c("sweet crabapple", "sweet crab apple")	Domesticated Plant GRIN Food
Malus hupehensis	c("tea crab apple", "Chinese crab apple")	Domesticated Plant GRIN Food
Malus ioensis	c("prairie crabapple", "prairie crab apple")	Domesticated Plant GRIN Food
Malva neglecta	c("dwarf mallow", "roundleaf mallow", "buttonweed", "cheeseplant", "cheeseweed", "common mallow")	Domesticated Plant GRIN Food
Malva sylvestris	c("high mallow", "garden mallow")	Domesticated Plant GRIN Food
Malva verticillata	c("cluster mallow", "whorled mallow", "clustered mallow", "Chinese mallow", "curled mallow", "mauve verticillée")	Domesticated Plant GRIN Food
Mammea americana	c("mamey", "mammee apple")	Domesticated Plant GRIN Food
Mangifera altissima	pahutan	Domesticated Plant GRIN Food
Mangifera caesia	binjai	Domesticated Plant GRIN Food
Mangifera foetida	bachang	Domesticated Plant GRIN Food
Manilkara zapota	c("naseberry", "sapodilla")	Domesticated Plant GRIN Food
Maranta arundinacea	arrowroot	Domesticated Plant GRIN Food
Matteuccia struthiopteris	ostrich fern	Domesticated Plant GRIN Food
Mauritia flexuosa	muriti	Domesticated Plant GRIN Food
Melicoccus bijugatus	Spanish lime	Domesticated Plant GRIN Food
Melilotus altissimus	tall yellow sweetclover	Domesticated Plant GRIN Food
Mentha suaveolens	c("bigleaf mint", "mint", "apple mint")	Domesticated Plant GRIN Food
Mesembryanthemum crystallinum	c("ice plant", "common iceplant", "crystalline iceplant")	Domesticated Plant GRIN Food
Mespilus germanica	c("medlar", "common medlar")	Domesticated Plant GRIN Food
Metroxylon sagu	sago palm	Domesticated Plant GRIN Food
Mirabilis expansa	mauka	Domesticated Plant GRIN Food
Momordica charantia	balsampear	Domesticated Plant GRIN Food
Momordica cochinchinensis	balsampear	Domesticated Plant GRIN Food
Momordica dioica	balsampear	Domesticated Plant GRIN Food
Monochoria hastata	c("monochoria", "arrowleaf falsepickerelweed")	Domesticated Plant GRIN Food
Monochoria vaginalis	c("pickerel weed", "heartshape falsepickerelweed", "heartshape false pickerelweed")	Domesticated Plant GRIN Food
Monstera deliciosa	tarovine	Domesticated Plant GRIN Food
Morella rubra	red bayberry	Domesticated Plant GRIN Food
Moringa oleifera	c("horseradish tree", "horseradishtree")	Domesticated Plant GRIN Food
Morrenia odorata	latexplant	Domesticated Plant GRIN Food
Morus nigra	black mulberry	Domesticated Plant GRIN Food
Morus rubra	red mulberry	Domesticated Plant GRIN Food
Mucuna pruriens	cowitch	Domesticated Plant GRIN Food
Muntingia calabura	c("strawberrytree", "calabura", "Jamaica cherry")	Domesticated Plant GRIN Food
Musa troglodytarum	fe'i banana	Domesticated Plant GRIN Food
Muscari comosum	tassel grape hyacinth	Domesticated Plant GRIN Food
Nasturtium officinale	watercress	Domesticated Plant GRIN Food
Nelumbo nucifera	sacred lotus	Domesticated Plant GRIN Food
Nephelium lappaceum	c("pulasan", "rambutan")	Domesticated Plant GRIN Food
Neptunia oleracea	garden puff	Domesticated Plant GRIN Food
Ocimum americanum	c("American basil", "hoary basil")	Domesticated Plant GRIN Food
Oenanthe javanica	Java waterdropwort	Domesticated Plant GRIN Food
Ongokea gore	boleko nut	Domesticated Plant GRIN Food
Opuntia ficus	c("Nopal de Castilla", "tuna cactus", "Indian-fig")	Domesticated Plant GRIN Food
Opuntia stricta	c("Nopal estricto", "erect pricklypear")	Domesticated Plant GRIN Food
Oryza sativa	rice	Domesticated Plant GRIN Food
Oxalis tuberosa	oca	Domesticated Plant GRIN Food
Oxytenanthera abyssinica	Abyssinia oxytenanthera	Domesticated Plant GRIN Food
Pachira aquatica	Guiana-chestnut	Domesticated Plant GRIN Food
Pachyrhizus ahipa	yam bean	Domesticated Plant GRIN Food
Pachyrhizus erosus	yam bean	Domesticated Plant GRIN Food
Pachyrhizus tuberosus	ajipo	Domesticated Plant GRIN Food
Palaquium gutta	gutta percha	Domesticated Plant GRIN Food
Pandanus dubius	c("bakong", "pandanus")	Domesticated Plant GRIN Food
Panicum hirticaule	c("Mexican panicgrass", "woodland panic", "roughstalk witchgrass")	Domesticated Plant GRIN Food
Panicum miliaceum	c("blackseeded proso millet", "panic millet", "proso", "wild millet", "wild proso millet", "panicum", "broomcorn millet", "hog millet", "proso millet", "broomcorn panic")	Domesticated Plant GRIN Food
Panicum sumatrense	little millet	Domesticated Plant GRIN Food
Parkia biglobosa	Clapperton's parkia	Domesticated Plant GRIN Food
Parmentiera aculeata	cuachilote	Domesticated Plant GRIN Food
Paspalum scrobiculatum	c("ricegrass paspalum", "kodomillet", "ricegrass", "Kodo-millet")	Domesticated Plant GRIN Food
Passiflora antioquiensis	passionflower	Domesticated Plant GRIN Food
Passiflora caerulea	c("blue passionflower", "bluecrown passionflower")	Domesticated Plant GRIN Food
Passiflora edulis	c("passionflower", "purple granadilla")	Domesticated Plant GRIN Food
Passiflora incarnata	purple passionflower	Domesticated Plant GRIN Food
Passiflora laurifolia	golden bellapple	Domesticated Plant GRIN Food
Passiflora ligularis	c("yellow passionfruit", "sweet granadilla")	Domesticated Plant GRIN Food
Passiflora maliformis	conch apple	Domesticated Plant GRIN Food
Passiflora mixta	passionflower	Domesticated Plant GRIN Food
Passiflora morifolia	woodland passionflower	Domesticated Plant GRIN Food
Passiflora quadrangularis	giant granadilla	Domesticated Plant GRIN Food
Passiflora tarminiana	banana poka	Domesticated Plant GRIN Food
Passiflora tripartita	banana poka	Domesticated Plant GRIN Food
Pastinaca sativa	wild parsnip	Domesticated Plant GRIN Food
Paullinia cupana	guarana	Domesticated Plant GRIN Food
Paullinia yoco	yoco	Domesticated Plant GRIN Food
Pediomelum esculentum	c("large Indian breadroot", "Indian breadroot", "breadroot scurfpea")	Domesticated Plant GRIN Food
Pentaclethra macrophylla	oilbean tree	Domesticated Plant GRIN Food
Pentadesma butyracea	butter tree	Domesticated Plant GRIN Food
Peperomia pellucida	man to man	Domesticated Plant GRIN Food
Pereskia aculeata	Barbados shrub	Domesticated Plant GRIN Food
Pereskia grandifolia	rose cactus	Domesticated Plant GRIN Food
Petasites japonicus	Japanese sweet coltsfoot	Domesticated Plant GRIN Food
Petroselinum crispum	parsley	Domesticated Plant GRIN Food
Phalaris canariensis	c("common canary grass", "common canarygrass", "annual canarygrass")	Domesticated Plant GRIN Food
Phaseolus acutifolius	tepary bean	Domesticated Plant GRIN Food
Phaseolus coccineus	scarlet runner	Domesticated Plant GRIN Food
Phaseolus lunatus	sieva bean	Domesticated Plant GRIN Food
Phaseolus vulgaris	kidney bean	Domesticated Plant GRIN Food
Phoenix sylvestris	wild date palm	Domesticated Plant GRIN Food
Phyllanthus acidus	c("Tahitian gooseberry tree", "Otaheite gooseberry")	Domesticated Plant GRIN Food
Phyllanthus emblica	emblic	Domesticated Plant GRIN Food
Phyllostachys bambusoides	Japanese timber bamboo	Domesticated Plant GRIN Food
Phyllostachys dulcis	sweetshoot bamboo	Domesticated Plant GRIN Food
Phyllostachys edulis	tortoise shell bamboo	Domesticated Plant GRIN Food
Phyllostachys flexuosa	drooping timber bamboo	Domesticated Plant GRIN Food
Physalis alkekengi	strawberry groundcherry	Domesticated Plant GRIN Food
Physalis angulata	c("cutleaf groundcherry", "cut-leaf ground-cherry", "lanceleaf groundcherry")	Domesticated Plant GRIN Food
Physalis grisea	strawberry-tomato	Domesticated Plant GRIN Food
Physalis heterophylla	c("clammy groundcherry", "clammy ground-cherry")	Domesticated Plant GRIN Food
Physalis peruviana	Peruvian groundcherry	Domesticated Plant GRIN Food
Physalis philadelphica	c("Mexican ground-cherry", "Mexican groundcherry")	Domesticated Plant GRIN Food
Physalis pubescens	c("husk tomato", "groundcherry", "husk-tomato")	Domesticated Plant GRIN Food
Phytolacca americana	c("pokeweed", "inkberry", "pigeonberry", "pokeberry", "common pokeweed", "phytolaque d'Amérique", "poke", "American pokeweed")	Domesticated Plant GRIN Food
Phytolacca rivinoides	Venezuelan pokeweed	Domesticated Plant GRIN Food
Pinus cembra	Swiss stone pine	Domesticated Plant GRIN Food
Pinus cembroides	c("Mexican nut pine", "nut pine", "stone pine", "pino piñonero", "piñón de Orizaba", "Mexican pinyon")	Domesticated Plant GRIN Food
Pinus densiflora	c("tanyosho pine", "Japanese red pine", "Japanese umbrella pine")	Domesticated Plant GRIN Food
Pinus edulis	c("twoneedle pinyon", "nut pine", "Colorado pinyon", "pinyon", "two-leaf pinyon", "two-needle pinyon", "piñón de Colorado", "piñon pine", "pinyon pine")	Domesticated Plant GRIN Food
Pinus gerardiana	c("chilghoza pine", "chilgoza pine", "Gerard's pine")	Domesticated Plant GRIN Food
Pinus koraiensis	c("Korean pine", "Chinese pinenut")	Domesticated Plant GRIN Food
Pinus monophylla	c("singleleaf pinyon", "nut pine", "one-leaf pine", "piñón simple")	Domesticated Plant GRIN Food
Pinus pinea	Italian stone pine	Domesticated Plant GRIN Food
Pinus pumila	c("Japanese stone pine", "dwarf Siberian pine")	Domesticated Plant GRIN Food
Pinus quadrifolia	c("nut pine", "four-needle pinyon", "piñón de California", "Parry pinyon")	Domesticated Plant GRIN Food
Pinus sibirica	Siberian pine	Domesticated Plant GRIN Food
Piper methysticum	kava	Domesticated Plant GRIN Food
Pistacia atlantica	Mt. Atlas mastic tree	Domesticated Plant GRIN Food
Pistacia chinensis	Chinese pistache	Domesticated Plant GRIN Food
Pistacia terebinthus	Cyprus turpentine	Domesticated Plant GRIN Food
Pithecellobium dulce	monkeypod	Domesticated Plant GRIN Food
Platycodon grandiflorus	c("balloon-flower", "Chinese-bellflower")	Domesticated Plant GRIN Food
Plectranthus amboinicus	Mexican mint	Domesticated Plant GRIN Food
Plectranthus barbatus	forskohlii	Domesticated Plant GRIN Food
Plectranthus esculentus	kaffir potato	Domesticated Plant GRIN Food
Portulaca oleracea	c("little hogweed", "little-hogweed", "purslane", "common purslane", "akulikuli-kula", "duckweed", "pursley", "wild portulaca", "garden purslane")	Domesticated Plant GRIN Food
Pouteria caimito	abiu	Domesticated Plant GRIN Food
Pouteria campechiana	c("eggfruit tree", "canistel")	Domesticated Plant GRIN Food
Pouteria multiflora	bullytree	Domesticated Plant GRIN Food
Pouteria sapota	c("naseberry", "sapote", "mamey sapote", "mammee sapote")	Domesticated Plant GRIN Food
Primula veris	cowslip primrose	Domesticated Plant GRIN Food
Prosopis alba	algarrobo blanco	Domesticated Plant GRIN Food
Prosopis chilensis	algarrobo	Domesticated Plant GRIN Food
Prosopis laevigata	smooth mesquite	Domesticated Plant GRIN Food
Prunus americana	American plum	Domesticated Plant GRIN Food
Prunus angustifolia	Chickasaw plum	Domesticated Plant GRIN Food
Prunus cerasifera	c("myrobalan plum", "ciruela chabacana", "cherry plum")	Domesticated Plant GRIN Food
Prunus fruticosa	European dwarf cherry	Domesticated Plant GRIN Food
Prunus hortulana	hortulan plum	Domesticated Plant GRIN Food
Prunus maritima	beach plum	Domesticated Plant GRIN Food
Prunus mume	Japanese apricot	Domesticated Plant GRIN Food
Prunus nigra	c("Canadian plum", "black plum")	Domesticated Plant GRIN Food
Prunus padus	European bird cherry	Domesticated Plant GRIN Food
Prunus pumila	c("sandcherry", "sand cherry")	Domesticated Plant GRIN Food
Prunus rivularis	creek plum	Domesticated Plant GRIN Food
Prunus serotina	c("black chokecherry", "black cherry")	Domesticated Plant GRIN Food
Prunus spinosa	blackthorn	Domesticated Plant GRIN Food
Prunus subcordata	Klamath plum	Domesticated Plant GRIN Food
Prunus tomentosa	Nanking cherry	Domesticated Plant GRIN Food
Pseudanamomis umbellulifera	ciruelas	Domesticated Plant GRIN Food
Psidium friedrichsthalianum	wild guava	Domesticated Plant GRIN Food
Psidium guineense	Guinea guava	Domesticated Plant GRIN Food
Psophocarpus tetragonolobus	winged bean	Domesticated Plant GRIN Food
Pteridium aquilinum	c("bracken", "bracken fern", "brackenfern", "northern bracken fern", "western brackenfern", "fougère des aigles")	Domesticated Plant GRIN Food
Pterocarpus soyauxii	barwood	Domesticated Plant GRIN Food
Pueraria montana	kudzu	Domesticated Plant GRIN Food
Punica granatum	pomegranate	Domesticated Plant GRIN Food
Pyrus ussuriensis	Chinese pear	Domesticated Plant GRIN Food
Quercus ilex	holly oak	Domesticated Plant GRIN Food
Raphanus sativus	c("cultivated radish", "radish", "garden radish", "wild radish")	Domesticated Plant GRIN Food
Raphia hookeri	Ivory Coast raphia palm	Domesticated Plant GRIN Food
Raphia sudanica	Sudan raphia palm	Domesticated Plant GRIN Food
Renealmia alpinia	jengibre-de-jardín	Domesticated Plant GRIN Food
Rhodomyrtus tomentosa	c("downy myrtle", "rose myrtle")	Domesticated Plant GRIN Food
Rhus chinensis	Chinese sumac	Domesticated Plant GRIN Food
Rhus copallinum	c("flameleaf sumac", "winged sumac", "shining sumac")	Domesticated Plant GRIN Food
Rhus integrifolia	lemonade sumac	Domesticated Plant GRIN Food
Rhynchosia totta	snoutbean	Domesticated Plant GRIN Food
Ribes aureum	golden currant	Domesticated Plant GRIN Food
Ribes divaricatum	c("straggly gooseberry", "spreading gooseberry")	Domesticated Plant GRIN Food
Ribes hirtellum	c("hairystem gooseberry", "hairy-stem gooseberry")	Domesticated Plant GRIN Food
Ribes niveum	c("white-flowered gooseberry", "snowy gooseberry", "snow currant")	Domesticated Plant GRIN Food
Ribes spicatum	currant	Domesticated Plant GRIN Food
Ribes uva	European gooseberry	Domesticated Plant GRIN Food
Rosa arkansana	c("prairie rose", "Arkansas rose", "prairie wildrose", "wild rose")	Domesticated Plant GRIN Food
Rosa laevigata	Cherokee rose	Domesticated Plant GRIN Food
Rosa roxburghii	c("Chinquapin rose", "chestnut rose")	Domesticated Plant GRIN Food
Rosa villosa	apple rose	Domesticated Plant GRIN Food
Rubus arcticus	arctic blackberry	Domesticated Plant GRIN Food
Rubus armeniacus	Himalayan blackberry	Domesticated Plant GRIN Food
Rubus caesius	European dewberry	Domesticated Plant GRIN Food
Rubus chamaemorus	cloudberry	Domesticated Plant GRIN Food
Rubus flagellaris	c("northern dewberry", "whiplash dewberry")	Domesticated Plant GRIN Food
Rubus glaucus	c("raspberry", "Andes berry")	Domesticated Plant GRIN Food
Rubus laciniatus	c("cut-leaved blackberry", "cutleaf blackberry")	Domesticated Plant GRIN Food
Rubus niveus	c("hill raspberry", "Mysore raspberry", "snowpeaks raspberry")	Domesticated Plant GRIN Food
Rubus occidentalis	black raspberry	Domesticated Plant GRIN Food
Rubus parvifolius	threeleaf blackberry	Domesticated Plant GRIN Food
Rubus phoenicolasius	c("Japanese wineberry", "wineberry", "wine raspberry")	Domesticated Plant GRIN Food
Rubus rosifolius	c("ola'a", "roseleaf raspberry", "thimbleberry", "West Indian raspberry")	Domesticated Plant GRIN Food
Rubus spectabilis	salmonberry	Domesticated Plant GRIN Food
Rubus trivialis	southern dewberry	Domesticated Plant GRIN Food
Rubus ursinus	California blackberry	Domesticated Plant GRIN Food
Rumex patientia	patience dock	Domesticated Plant GRIN Food
Rumex rugosus	wrinkled dock	Domesticated Plant GRIN Food
Rumex scutatus	French sorrel	Domesticated Plant GRIN Food
Saba senegalensis	Senegal saba	Domesticated Plant GRIN Food
Saccharum barberi	Barber's cane	Domesticated Plant GRIN Food
Saccharum sinense	Chinese cane	Domesticated Plant GRIN Food
Sagittaria sagittifolia	c("arrowhead", "Hawaii arrowhead")	Domesticated Plant GRIN Food
Salicornia bigelovii	dwarf saltwort	Domesticated Plant GRIN Food
Salvia columbariae	chia	Domesticated Plant GRIN Food
Salvia hispanica	chia	Domesticated Plant GRIN Food
Salvia potus	chia	Domesticated Plant GRIN Food
Sambucus canadensis	American elder	Domesticated Plant GRIN Food
Sambucus mexicana	Mexican elder	Domesticated Plant GRIN Food
Sambucus nigra	c("European black elder", "European elderberry", "European black elderberry", "elder", "elderberry", "common elderberry", "black elderberry")	Domesticated Plant GRIN Food
Sambucus racemosa	c("European red elder", "scarlet elderberry", "red elderberry")	Domesticated Plant GRIN Food
Sauropus androgynus	c("chekkurmanis", "sweet leaf", "star-gooseberry", "katuk")	Domesticated Plant GRIN Food
Schinziophyton rautanenii	manketti	Domesticated Plant GRIN Food
Schleichera oleosa	lac tree	Domesticated Plant GRIN Food
Sclerocarya birrea	marula	Domesticated Plant GRIN Food
Scolymus hispanicus	c("common goldenthistle", "golden thistle")	Domesticated Plant GRIN Food
Scorzonera hispanica	black salsify	Domesticated Plant GRIN Food
Sechium edule	chayote	Domesticated Plant GRIN Food
Senna occidentalis	c("septicweed", "coffee senna")	Domesticated Plant GRIN Food
Senna tora	sickle senna	Domesticated Plant GRIN Food
Sesamum radiatum	sesamum	Domesticated Plant GRIN Food
Sesbania grandiflora	vegetable hummingbird	Domesticated Plant GRIN Food
Setaria italica	c("Italian bristle grass", "Italian foxtail", "foxtail bristlegrass", "foxtail millet")	Domesticated Plant GRIN Food
Setaria palmifolia	c("broadleaved bristlegrass", "hailans pitpit", "short pitpit", "palmgrass")	Domesticated Plant GRIN Food
Setaria pumila	c("yellow bristlegrass", "yellow bristle grass", "cattail grass")	Domesticated Plant GRIN Food
Shepherdia argentea	silver buffaloberry	Domesticated Plant GRIN Food
Sicana odorifera	casa banana	Domesticated Plant GRIN Food
Silene vulgaris	c("bladder silene", "maiden's-tears", "bladder campion", "cowbell", "maiden's tears", "rattleweed", "maidenstears")	Domesticated Plant GRIN Food
Simarouba glauca	c("bitter damson", "bitterwood", "bitter ash", "paradise-tree", "paradisetree", "paradise tree")	Domesticated Plant GRIN Food
Sinapis alba	white mustard	Domesticated Plant GRIN Food
Sium sisarum	skirret	Domesticated Plant GRIN Food
Solanum aethiopicum	Ethiopian nightshade	Domesticated Plant GRIN Food
Solanum americanum	American black nightshade	Domesticated Plant GRIN Food
Solanum capsicoides	cockroach berry	Domesticated Plant GRIN Food
Solanum cardiophyllum	c("heartleaf horsenettle", "heartleaf nightshade")	Domesticated Plant GRIN Food
Solanum macrocarpon	nightshade	Domesticated Plant GRIN Food
Solanum muricatum	pepino	Domesticated Plant GRIN Food
Solanum nigrum	black nightshade	Domesticated Plant GRIN Food
Solanum pimpinellifolium	currant tomato	Domesticated Plant GRIN Food
Solanum quitoense	naranjilla	Domesticated Plant GRIN Food
Solanum sessiliflorum	cocona	Domesticated Plant GRIN Food
Solanum torvum	c("turkey berry", "terongan", "bhankatiya", "devil's fig", "fausse aubergine", "kausoni", "prickly solanum", "turkeyberry")	Domesticated Plant GRIN Food
Sorbus aucuparia	c("rowan", "rowan-berry", "European mountain-ash")	Domesticated Plant GRIN Food
Sorbus domestica	servicetree	Domesticated Plant GRIN Food
Sorbus torminalis	c("checkertree", "chequers", "wild servicetree")	Domesticated Plant GRIN Food
Sphenostylis stenocarpa	African yam bean	Domesticated Plant GRIN Food
Spondias dulcis	c("ambarella", "Jewish plum")	Domesticated Plant GRIN Food
Spondias mombin	c("hogplum", "yellow mombin")	Domesticated Plant GRIN Food
Spondias purpurea	purple mombin	Domesticated Plant GRIN Food
Spondias tuberosa	imbu	Domesticated Plant GRIN Food
Stachys affinis	artichoke betony	Domesticated Plant GRIN Food
Stelechocarpus burahol	burahol	Domesticated Plant GRIN Food
Stellaria media	c("chickweed", "nodding chickweed", "common chickweed")	Domesticated Plant GRIN Food
Stenocereus thurberi	c("organpipe cactus", "Pitayo dulce")	Domesticated Plant GRIN Food
Sterculia foetida	hazel sterculia	Domesticated Plant GRIN Food
Sterculia urens	sterculia	Domesticated Plant GRIN Food
Strychnos spinosa	Natal orange	Domesticated Plant GRIN Food
Styrax benzoin	styrax	Domesticated Plant GRIN Food
Styrax tonkinensis	Siam benzoin	Domesticated Plant GRIN Food
Suaeda nigra	bush seepweed	Domesticated Plant GRIN Food
Syagrus coronata	Ouricury palm	Domesticated Plant GRIN Food
Synsepalum dulcificum	miraculous berry	Domesticated Plant GRIN Food
Syzygium aqueum	watery roseapple	Domesticated Plant GRIN Food
Syzygium cumini	c("Java plum", "duhat", "jambolan plum", "jamelonguier", "kavika ni India", "mesegerak")	Domesticated Plant GRIN Food
Syzygium jambos	c("Malabar plum", "apel en wai", "iouen wai", "kavika ni India", "kavika ni vavalangi", "rose-apple")	Domesticated Plant GRIN Food
Syzygium malaccense	Malaysian apple	Domesticated Plant GRIN Food
Tacca leontopetaloides	c("Polynesian arrowroot", "batflower")	Domesticated Plant GRIN Food
Talinum fruticosum	Verdolaga-Francesa	Domesticated Plant GRIN Food
Tamarindus indica	tamarind	Domesticated Plant GRIN Food
Taraxacum officinale	c("common dandelion", "blowball", "faceclock", "dandelion")	Domesticated Plant GRIN Food
Telfairia occidentalis	oysternut	Domesticated Plant GRIN Food
Telfairia pedata	oysternut	Domesticated Plant GRIN Food
Tephroseris palustris	marsh fleabane	Domesticated Plant GRIN Food
Terminalia catappa	c("India almond", "false kamani", "Indian almond", "tropical almond")	Domesticated Plant GRIN Food
Theobroma angustifolium	theobroma	Domesticated Plant GRIN Food
Theobroma bicolor	theobroma	Domesticated Plant GRIN Food
Theobroma grandiflorum	theobroma	Domesticated Plant GRIN Food
Theobroma simiarum	theobroma	Domesticated Plant GRIN Food
Thespesia populnea	c("portia tree", "seaside mahoe", "cork-tree", "Spanish cork", "majagua")	Domesticated Plant GRIN Food
Torreya nucifera	Japanese torreya	Domesticated Plant GRIN Food
Tragopogon porrifolius	c("salsify", "purple salsify", "common salsify", "goatsbeard")	Domesticated Plant GRIN Food
Trapa natans	c("water nut", "water chestnut")	Domesticated Plant GRIN Food
Treculia africana	African breadfruit	Domesticated Plant GRIN Food
Triadica sebifera	c("tallowtree", "Chinese tallow")	Domesticated Plant GRIN Food
Trichosanthes cucumerina	snakegourd	Domesticated Plant GRIN Food
Trichosanthes dioica	pointed gourd	Domesticated Plant GRIN Food
Trifolium aureum	golden clover	Domesticated Plant GRIN Food
Trifolium incarnatum	crimson clover	Domesticated Plant GRIN Food
Trigonella corniculata	cultivated fenugreek	Domesticated Plant GRIN Food
Trigonella foenum	sicklefruit fenugreek	Domesticated Plant GRIN Food
Triphasia trifolia	c("demon de China", "limon-China", "limoncito", "limeberry")	Domesticated Plant GRIN Food
Triticum aestivum	c("common wheat", "wheat")	Domesticated Plant GRIN Food
Triticum ispahanicum	wheat	Domesticated Plant GRIN Food
Triticum monococcum	einkorn	Domesticated Plant GRIN Food
Triticum timopheevii	Timopheev's wheat	Domesticated Plant GRIN Food
Triticum turgidum	rivet wheat	Domesticated Plant GRIN Food
Triticum zhukovskyi	Zhukovsky's wheat	Domesticated Plant GRIN Food
Tropaeolum majus	nasturtium	Domesticated Plant GRIN Food
Tropaeolum minus	dwarf nasturtium	Domesticated Plant GRIN Food
Tropaeolum tuberosum	anu	Domesticated Plant GRIN Food
Ugni molinae	Chilean guava	Domesticated Plant GRIN Food
Ullucus tuberosus	ulluco	Domesticated Plant GRIN Food
Urochloa ramosa	dixie signalgrass	Domesticated Plant GRIN Food
Vaccinium angustifolium	c("lowbush blueberry", "sweet lowbush blueberry")	Domesticated Plant GRIN Food
Vaccinium bracteatum	sea bilberry	Domesticated Plant GRIN Food
Vaccinium corymbosum	c("highbush blueberry", "New Jersey blueberry", "Southern blueberry", "smallflower blueberry")	Domesticated Plant GRIN Food
Vaccinium formosum	southern blueberry	Domesticated Plant GRIN Food
Vaccinium fuscatum	black highbush blueberry	Domesticated Plant GRIN Food
Vaccinium myrtilloides	c("velvetleaf huckleberry", "velvetleaf blueberry", "sour-top blueberry")	Domesticated Plant GRIN Food
Vaccinium myrtillus	c("myrtle blueberry", "myrtle whortleberry", "whortleberry")	Domesticated Plant GRIN Food
Vaccinium reticulatum	ohelo 'ai	Domesticated Plant GRIN Food
Vaccinium uliginosum	bog blueberry	Domesticated Plant GRIN Food
Vaccinium virgatum	smallflower blueberry	Domesticated Plant GRIN Food
Vaccinium vitis	c("lingonberry", "northern mountain cranberry")	Domesticated Plant GRIN Food
Valerianella eriocarpa	Italian cornsalad	Domesticated Plant GRIN Food
Valerianella locusta	Lewiston cornsalad	Domesticated Plant GRIN Food
Vangueria madagascariensis	voa vanga	Domesticated Plant GRIN Food
Viburnum opulus	c("Guelder rose", "viburnum", "European cranberrybush")	Domesticated Plant GRIN Food
Vicia articulata	oneflower vetch	Domesticated Plant GRIN Food
Vicia ervilia	blister vetch	Domesticated Plant GRIN Food
Vicia hirsuta	c("tiny vetch", "hairy vetch")	Domesticated Plant GRIN Food
Vicia sativa	c("garden vetch", "common vetch", "tare", "narrowleaf vetch")	Domesticated Plant GRIN Food
Vigna aconitifolia	moth bean	Domesticated Plant GRIN Food
Vigna mungo	black gram	Domesticated Plant GRIN Food
Vigna umbellata	rice bean	Domesticated Plant GRIN Food
Vigna vexillata	zombi pea	Domesticated Plant GRIN Food
Viola tricolor	c("pansy violet", "Johnny-jump-up")	Domesticated Plant GRIN Food
Vitex glabrata	smooth chastetree	Domesticated Plant GRIN Food
Vitis aestivalis	summer grape	Domesticated Plant GRIN Food
Vitis amurensis	Amur grape	Domesticated Plant GRIN Food
Vitis labrusca	fox grape	Domesticated Plant GRIN Food
Vitis rotundifolia	c("muscadine", "muscadine grape")	Domesticated Plant GRIN Food
Vitis vulpina	c("wild grape", "fox grape", "frost grape")	Domesticated Plant GRIN Food
Wolffia globosa	Asian watermeal	Domesticated Plant GRIN Food
Xanthosoma brasiliense	Tahitian spinach	Domesticated Plant GRIN Food
Xanthosoma caracu	yautia horqueta	Domesticated Plant GRIN Food
Ximenia americana	c("tallow wood", "tallowwood")	Domesticated Plant GRIN Food
Zizania latifolia	Manchurian wildrice	Domesticated Plant GRIN Food
Zizania palustris	northern wildrice	Domesticated Plant GRIN Food
Ziziphus mauritiana	Indian jujube	Domesticated Plant GRIN Food
Agrostis canina	velvet bentgrass	Domesticated Plant GRIN Lawn
Agrostis capillaris	c("colonial bentgrass", "colonial bent")	Domesticated Plant GRIN Lawn
Agrostis castellana	bentgrass	Domesticated Plant GRIN Lawn
Agrostis gigantea	c("redtop", "black bent", "water bentgrass")	Domesticated Plant GRIN Lawn
Agrostis idahoensis	c("Idaho bentgrass", "Idaho redtop")	Domesticated Plant GRIN Lawn
Agrostis nebulosa	cloud bentgrass	Domesticated Plant GRIN Lawn
Agrostis stolonifera	c("creeping bentgrass", "carpet bentgrass", "spreading bent", "creeping bent", "redtop", "redtop bent", "seaside bentgrass")	Domesticated Plant GRIN Lawn
Axonopus compressus	broadleaf carpetgrass	Domesticated Plant GRIN Lawn
Axonopus fissifolius	c("common carpetgrass", "carpetgrass", "Louisiana grass", "mat grass", "narrowleaved carpetgrass")	Domesticated Plant GRIN Lawn
Bothriochloa pertusa	pitted beardgrass	Domesticated Plant GRIN Lawn
Bouteloua curtipendula	sideoats grama	Domesticated Plant GRIN Lawn
Bouteloua gracilis	blue grama	Domesticated Plant GRIN Lawn
Chrysopogon aciculatus	c("golden false beardgrass", "pilipiliula", "golden beardgrass", "inifuk", "Mackie's pest", "matapekepeke", "seed grass")	Domesticated Plant GRIN Lawn
Cynodon dactylon	c("chiendent pied-de-poule", "devilgrass", "grama-seda", "manienie", "motie molulu", "Bermudagrass", "common bermudagrass")	Domesticated Plant GRIN Lawn
Cynodon transvaalensis	c("Bermudagrass", "African dogstooth grass")	Domesticated Plant GRIN Lawn
Deschampsia cespitosa	tufted hairgrass	Domesticated Plant GRIN Lawn
Dichanthium aristatum	Angleton bluestem	Domesticated Plant GRIN Lawn
Dichondra micrantha	Asian ponysfoot	Domesticated Plant GRIN Lawn
Digitaria didactyla	crabgrass	Domesticated Plant GRIN Lawn
Distichlis spicata	c("desert saltgrass", "marsh spikegrass", "saltgrass", "inland saltgrass", "seashore saltgrass")	Domesticated Plant GRIN Lawn
Elymus lanceolatus	c("streambank wheatgrass", "streamside wild rye")	Domesticated Plant GRIN Lawn
Eragrostis tenella	Japanese lovegrass	Domesticated Plant GRIN Lawn
Eremochloa ophiuroides	centipede grass	Domesticated Plant GRIN Lawn
Festuca arundinacea	c("Alta fescue", "coarse fescue", "reed fescue", "tall fescue")	Domesticated Plant GRIN Lawn
Festuca filiformis	fineleaf sheep fescue	Domesticated Plant GRIN Lawn
Festuca ovina	sheep fescue	Domesticated Plant GRIN Lawn
Festuca rubra	c("red fescue", "ravine fescue")	Domesticated Plant GRIN Lawn
Festuca trachyphylla	hard fescue	Domesticated Plant GRIN Lawn
Hilaria belangeri	c("curly mesquite", "curly-mesquite", "Common curleymesquite", "curleymesquite", "curlymesquite")	Domesticated Plant GRIN Lawn
Holcus mollis	creeping velvetgrass	Domesticated Plant GRIN Lawn
Koeleria macrantha	c("junegrass", "prairie Junegrass")	Domesticated Plant GRIN Lawn
Lolium multiflorum	c("annual ryegrass", "Italian ryegrass")	Domesticated Plant GRIN Lawn
Lolium perenne	c("perennial rye grass", "perennial ryegrass", "Italian ryegrass")	Domesticated Plant GRIN Lawn
Paspalum notatum	c("Bahia grass", "bahiagrass")	Domesticated Plant GRIN Lawn
Paspalum vaginatum	seashore paspalum	Domesticated Plant GRIN Lawn
Phyla canescens	c("hairy fogfruit", "hairy frogfruit", "carpet-grass")	Domesticated Plant GRIN Lawn
Poa annua	c("annual blue grass", "walkgrass", "annual bluegrass")	Domesticated Plant GRIN Lawn
Poa arachnifera	Texas bluegrass	Domesticated Plant GRIN Lawn
Poa compressa	c("flat-stem blue grass", "Canada bluegrass")	Domesticated Plant GRIN Lawn
Poa nemoralis	c("forest blue grass", "wood bluegrass")	Domesticated Plant GRIN Lawn
Poa pratensis	Kentucky bluegrass	Domesticated Plant GRIN Lawn
Poa supina	bluegrass	Domesticated Plant GRIN Lawn
Poa trivialis	rough bluegrass	Domesticated Plant GRIN Lawn
Puccinellia distans	c("spreading alkali grass", "weeping alkaligrass", "European alkaligrass")	Domesticated Plant GRIN Lawn
Stenotaphrum secundatum	c("St. Augustine grass", "St. Augustinegrass")	Domesticated Plant GRIN Lawn
Trifolium fragiferum	strawberry clover	Domesticated Plant GRIN Lawn
Trisetum flavescens	yellow oatgrass	Domesticated Plant GRIN Lawn
Zoysia japonica	Korean lawngrass	Domesticated Plant GRIN Lawn
Zoysia matrella	Manila grass	Domesticated Plant GRIN Lawn
Zoysia tenuifolia	Mascarene grass	Domesticated Plant GRIN Lawn
Atelerix albiventris	Domesticated hedgehog (Atelerix albiventris)	Domesticated Animal Wikipedia
Bombyx mori	Domestic silkmoth (Bombyx mori)	Domesticated Animal Wikipedia
Bos primigenius	European cattle or taurine cattle (Bos primigenius taurus)[3][23][24]	Domesticated Animal Wikipedia
Capra aegagrus	Domestic goat (Capra aegagrus hircus)	Domesticated Animal Wikipedia
Carassius auratus	Domestic goldfish (Carassius auratus)	Domesticated Animal Wikipedia
Cavia porcellus	Guinea pig (Cavia porcellus)	Domesticated Animal Wikipedia
Columba livia	Domestic pigeon (Columba livia domestica)	Domesticated Animal Wikipedia
Cyprinus rubrofuscus	Koi (Cyprinus rubrofuscus)	Domesticated Animal Wikipedia
Equus africanus	Domestic donkey or domestic ass (Equus africanus asinus)	Domesticated Animal Wikipedia
Felis catus	Domestic cat or house cat (Felis catus)[3]	Domesticated Animal Wikipedia
Gallus gallus	Domestic chicken (Gallus gallus domesticus)	Domesticated Animal Wikipedia
Lonchura striata	Society finch (Lonchura striata domestica)	Domesticated Animal Wikipedia
Lycalopex culpaeus	Fuegian dog (Lycalopex culpaeus)†	Domesticated Animal Wikipedia
Mephitis mephitis	Domesticated striped skunk (Mephitis mephitis)	Domesticated Animal Wikipedia
Mus musculus	Fancy mouse and laboratory mouse (Mus musculus domestica)	Domesticated Animal Wikipedia
Mustela putorius	Domestic ferret (Mustela putorius furo)	Domesticated Animal Wikipedia
Neovison vison	Domestic mink (Neovison vison domesticus)[49]	Domesticated Animal Wikipedia
Numida meleagris	Domestic guineafowl (Numida meleagris domesticus)	Domesticated Animal Wikipedia
Poecilia reticulata	Guppy (Poecilia reticulata);[47]Cauca (P. caucana), Amazon (P. formosa), sailfin (P. latipinna), shortfin (P. mexicana), liberty (P. salvatoris), common (P. sphenops), and Yucatan mollies (P. velifera); Endler's livebearer (P. wingei)	Domesticated Animal Wikipedia
Rattus norvegicus	Fancy rat and laboratory rat (Rattus norvegicus domestica)	Domesticated Animal Wikipedia
Serinus canaria	Domestic canary (Serinus canaria domestica)	Domesticated Animal Wikipedia
Streptopelia risoria	Barbary dove or ringed turtle dove (Streptopelia risoria)	Domesticated Animal Wikipedia
Vulpes vulpes amicus	Domesticated silver fox (Vulpes vulpes amicus)	Domesticated Animal Wikipedia
Avena	Oats	Domesticated Plant Cereal Wikipedia
Chenopodum quinoa	Quinoa	Domesticated Plant Cereal Wikipedia
Digitaria	Fonio	Domesticated Plant Cereal Wikipedia
Echinocloa frumentacea	Millet	Domesticated Plant Cereal Wikipedia
Eragrostis abyssinica	Teff	Domesticated Plant Cereal Wikipedia
Fagopyrum	Buckwheat	Domesticated Plant Cereal Wikipedia
Hordeum	Barley	Domesticated Plant Cereal Wikipedia
Sorghum	Sorghum	Domesticated Plant Cereal Wikipedia
Achillea millefolium	Yarrow	Domesticated Plant Vegetable Wikipedia
Adansonia	Kuka	Domesticated Plant Vegetable Wikipedia
Alaria esculenta	Dabberlocks (Badderlocks)	Domesticated Plant Vegetable Wikipedia
Allium ampeloprasum 	Elephant garlic	Domesticated Plant Vegetable Wikipedia
Allium cepa 	Potato onion	Domesticated Plant Vegetable Wikipedia
Allium schoenoprasum	Chives	Domesticated Plant Vegetable Wikipedia
Allium tricoccum	Wild leek	Domesticated Plant Vegetable Wikipedia
Allium wakegi	Spring onion / Scallion	Domesticated Plant Vegetable Wikipedia
Alpinia galanga	Galangal	Domesticated Plant Vegetable Wikipedia
Anethum graveolens	Dill	Domesticated Plant Vegetable Wikipedia
Apium graveolens 	Celeriac	Domesticated Plant Vegetable Wikipedia
Armoracia rusticana	Horseradish	Domesticated Plant Vegetable Wikipedia
Bambusa vulgarisPhyllostachys edulis	Bamboo shoot	Domesticated Plant Vegetable Wikipedia
Beta vulgaris cicla 	Swiss chard	Domesticated Plant Vegetable Wikipedia
Beta vulgaris maritima	Sea beet	Domesticated Plant Vegetable Wikipedia
Beta vulgaris vulgaris	Beet (greens)	Domesticated Plant Vegetable Wikipedia
Brassica rapa 	Bok choy (白菜)	Domesticated Plant Vegetable Wikipedia
Callophyllis variegata	Carola	Domesticated Plant Vegetable Wikipedia
Camassia	Camas	Domesticated Plant Vegetable Wikipedia
Canna	Canna	Domesticated Plant Vegetable Wikipedia
Capsella bursa-pastoris	Shepherd's purse	Domesticated Plant Vegetable Wikipedia
Capsicum annuum 	Sweet pepper	Domesticated Plant Vegetable Wikipedia
Caulerpa	Sea grape	Domesticated Plant Vegetable Wikipedia
Chenopodium bonus-henricus	Good King Henry	Domesticated Plant Vegetable Wikipedia
Chrysanthemum coronarium	Garland Chrysanthemum	Domesticated Plant Vegetable Wikipedia
Citrullus Lanatus	Water melon	Domesticated Plant Vegetable Wikipedia
Cladosiphon okamuranus	Mozuku	Domesticated Plant Vegetable Wikipedia
Cnidoscolus aconitifolius aconitifolius	Chaya	Domesticated Plant Vegetable Wikipedia
Conopodium majus	Pignut	Domesticated Plant Vegetable Wikipedia
Corchorus olitoriusCorchorus capsularis	Melokhia	Domesticated Plant Vegetable Wikipedia
Crassocephalum	Sierra Leone bologi	Domesticated Plant Vegetable Wikipedia
Cucumis melo var. flexuosus	Armenian cucumber	Domesticated Plant Vegetable Wikipedia
Cucurbita	Pumpkin	Domesticated Plant Vegetable Wikipedia
Curcuma longa	Turmeric	Domesticated Plant Vegetable Wikipedia
Cyamopsis tetragonoloba	Guar	Domesticated Plant Vegetable Wikipedia
Cymbopogon citratus	Lemongrass	Domesticated Plant Vegetable Wikipedia
Cynara cardunculus / scolymus	Artichoke	Domesticated Plant Vegetable Wikipedia
Eisenia bicyclis	Arame	Domesticated Plant Vegetable Wikipedia
Eruca sativa	Arugula	Domesticated Plant Vegetable Wikipedia
Foeniculum vulgare 	Florence fennel	Domesticated Plant Vegetable Wikipedia
Hemerocallis fulva	Daylily[1]	Domesticated Plant Vegetable Wikipedia
Hizikia fusiformis	Hijiki	Domesticated Plant Vegetable Wikipedia
Hypochaeris radicata	Catsear	Domesticated Plant Vegetable Wikipedia
Inula crithmoides	Golden samphire	Domesticated Plant Vegetable Wikipedia
Lactuca sativa 	Celtuce	Domesticated Plant Vegetable Wikipedia
Luffa cylindrica	Luffa	Domesticated Plant Vegetable Wikipedia
Malvaceae	Mallow	Domesticated Plant Vegetable Wikipedia
Melothria scabra	Cucamelon / Mouse melon	Domesticated Plant Vegetable Wikipedia
MonostromaEnteromorpha	Aonori	Domesticated Plant Vegetable Wikipedia
Ornithogalum pyrenaicum	Prussian asparagus	Domesticated Plant Vegetable Wikipedia
Palmaria palmata	Dulse (Dillisk)	Domesticated Plant Vegetable Wikipedia
Petroselinum crispum tuberosum	Hamburg parsley	Domesticated Plant Vegetable Wikipedia
Plantago major	Greater plantain	Domesticated Plant Vegetable Wikipedia
Porphyra	Nori	Domesticated Plant Vegetable Wikipedia
Praecitrullus fistulosus	Tinda	Domesticated Plant Vegetable Wikipedia
Psoralea esculenta	Prairie turnip	Domesticated Plant Vegetable Wikipedia
Pteridium aquilinumAthyrium esculentum	Fiddlehead	Domesticated Plant Vegetable Wikipedia
Raphanus sativus 	Daikon	Domesticated Plant Vegetable Wikipedia
Rumex acetosa	Sorrel	Domesticated Plant Vegetable Wikipedia
Sagittaria latifolia	Broadleaf arrowhead	Domesticated Plant Vegetable Wikipedia
Silene inflata	Sculpit / Stridolo	Domesticated Plant Vegetable Wikipedia
Stellaria	Chickweed	Domesticated Plant Vegetable Wikipedia
Tetragonia tetragonioides	New Zealand Spinach	Domesticated Plant Vegetable Wikipedia
Trapa natansTrapa bicornis	Water caltrop	Domesticated Plant Vegetable Wikipedia
Ulva lactuca	Sea lettuce	Domesticated Plant Vegetable Wikipedia
Veronica beccabunga	Brooklime	Domesticated Plant Vegetable Wikipedia
Vigna acontifolia	Moth bean	Domesticated Plant Vegetable Wikipedia
Vigna unguiculata 	Asparagus bean	Domesticated Plant Vegetable Wikipedia
Vigna unguiculata unguiculata	Black-eyed pea	Domesticated Plant Vegetable Wikipedia
Vitis	Grape (leaves)	Domesticated Plant Vegetable Wikipedia
Wasabia japonica	Wasabi	Domesticated Plant Vegetable Wikipedia
Acronychia acidula	Lemon aspen fruit	Domesticated Plant Fruit Wikipedia
Acronychia oblongifolia	White aspen berry	Domesticated Plant Fruit Wikipedia
Acrotriche depressa	Native currant	Domesticated Plant Fruit Wikipedia
Aglaia teysmanniana	Aglaia teysmanniana	Domesticated Plant Fruit Wikipedia
Annona conica	Annona conica	Domesticated Plant Fruit Wikipedia
Annona crassiflora	Marolo	Domesticated Plant Fruit Wikipedia
Annona diversifolia	Ilama	Domesticated Plant Fruit Wikipedia
Annona scleroderma	Cawesh	Domesticated Plant Fruit Wikipedia
Annona senegalensis	African custard-apple	Domesticated Plant Fruit Wikipedia
Annona squamosa × annona cherimola	Atemoya	Domesticated Plant Fruit Wikipedia
Archirhodomyrtus beckleri	Small-leaved myrtle berry	Domesticated Plant Fruit Wikipedia
Arctostaphylos uva-ursi	Bearberry	Domesticated Plant Fruit Wikipedia
Ardisia elliptica	Shoebutton ardisia	Domesticated Plant Fruit Wikipedia
Aristotelia chilensis	Maqui berry	Domesticated Plant Fruit Wikipedia
Artocarpus hirsutus	Wild jack	Domesticated Plant Fruit Wikipedia
Artocarpus hypargyreus	Kwai muk	Domesticated Plant Fruit Wikipedia
Austromyrtus dulcis	Midgen berry	Domesticated Plant Fruit Wikipedia
Azadirachta indica	Neem	Domesticated Plant Fruit Wikipedia
Berberis darwinii	Darwin's barberry	Domesticated Plant Fruit Wikipedia
Berberis vulgaris	Barberry	Domesticated Plant Fruit Wikipedia
Billardiera cymosa	Sweet apple-berry	Domesticated Plant Fruit Wikipedia
Billardiera longiflora	Purple apple-berry	Domesticated Plant Fruit Wikipedia
Billardiera scandens	Apple berry	Domesticated Plant Fruit Wikipedia
Boquila trifoliolata	Boquila	Domesticated Plant Fruit Wikipedia
Buchanania arborescens	Little gooseberry	Domesticated Plant Fruit Wikipedia
Buchanania obovata	Green plum	Domesticated Plant Fruit Wikipedia
Bunchosia glandulifera	Peanut butter fruit	Domesticated Plant Fruit Wikipedia
Calamus manillensis	Yantok	Domesticated Plant Fruit Wikipedia
Calligonum junceum	Calligonum junceum	Domesticated Plant Fruit Wikipedia
Capparis mitchellii	Wild orange	Domesticated Plant Fruit Wikipedia
Carpobrotus glaucescens	Angular sea-fig	Domesticated Plant Fruit Wikipedia
Carpobrotus rossii	Karkalla fruit	Domesticated Plant Fruit Wikipedia
Cassytha melantha	Coarse dodder-laurel fruit	Domesticated Plant Fruit Wikipedia
Celtis occidentalis	Hackberry	Domesticated Plant Fruit Wikipedia
Cereus repandus	Peruvian apple cactus fruit	Domesticated Plant Fruit Wikipedia
Citrofortunella microcarpa	Calamondin	Domesticated Plant Fruit Wikipedia
Citropsis articulata	African cherry orange	Domesticated Plant Fruit Wikipedia
Citrus × clementina	Clementine	Domesticated Plant Fruit Wikipedia
Citrus × depressa	Taiwan tangerine	Domesticated Plant Fruit Wikipedia
Citrus × iyo	Iyokan	Domesticated Plant Fruit Wikipedia
Citrus × limonia	Rangpur	Domesticated Plant Fruit Wikipedia
Citrus × limonimedica	Florentine citron	Domesticated Plant Fruit Wikipedia
Citrus × meyeri	Meyer lemon	Domesticated Plant Fruit Wikipedia
Citrus × natsudaidai	Amanatsu	Domesticated Plant Fruit Wikipedia
Citrus × paradisi	Grapefruit	Domesticated Plant Fruit Wikipedia
Citrus × pyriformis	Ponderosa lemon	Domesticated Plant Fruit Wikipedia
Citrus × sinensis	Orange	Domesticated Plant Fruit Wikipedia
Citrus × sinensis 'Blood Orange'	Blood orange	Domesticated Plant Fruit Wikipedia
Citrus × tangelo	Tangelo	Domesticated Plant Fruit Wikipedia
Citrus australasica var. sanguinea × 'Ellendale Mandarin'	Blood lime	Domesticated Plant Fruit Wikipedia
Citrus bergamia	Bergamot orange	Domesticated Plant Fruit Wikipedia
Citrus cavaleriei	Ichang papeda	Domesticated Plant Fruit Wikipedia
Citrus cavaleriei × citrus	Shangjuan	Domesticated Plant Fruit Wikipedia
Citrus flaviculpus	Ōgonkan	Domesticated Plant Fruit Wikipedia
Citrus flaviculpus × citrus unshiu	Shonan gold	Domesticated Plant Fruit Wikipedia
Citrus glauca	Desert lime	Domesticated Plant Fruit Wikipedia
Citrus grandis × citrus paradisi	Oroblanco	Domesticated Plant Fruit Wikipedia
Citrus junos	Yuzu	Domesticated Plant Fruit Wikipedia
Citrus limetta	Sweet limetta	Domesticated Plant Fruit Wikipedia
Citrus limon	Lemon	Domesticated Plant Fruit Wikipedia
Citrus mangshanensis	Mangshanyegan	Domesticated Plant Fruit Wikipedia
Citrus margarita	Oval kumquat	Domesticated Plant Fruit Wikipedia
Citrus margarita 'Centennial Variegated Kumquat'	Centennial variegated kumquat	Domesticated Plant Fruit Wikipedia
Citrus medica ssp. bajoura	Bajoura citron	Domesticated Plant Fruit Wikipedia
Citrus medica var. ethrog	Etrog	Domesticated Plant Fruit Wikipedia
Citrus medica var. sarcodactylis	Buddha's hand	Domesticated Plant Fruit Wikipedia
Citrus myrtifolia	Myrtle-leaved orange	Domesticated Plant Fruit Wikipedia
Citrus nobilis × citrus × deliciosa	Kinnow	Domesticated Plant Fruit Wikipedia
Citrus obovata	Jiangsu kumquat	Domesticated Plant Fruit Wikipedia
Citrus reticulata × citrus paradisi	Ugli fruit	Domesticated Plant Fruit Wikipedia
Citrus reticulata × sinensis	Cam sành	Domesticated Plant Fruit Wikipedia
Citrus sphaerocarpa	Kabosu	Domesticated Plant Fruit Wikipedia
Citrus sudachi	Sudachi	Domesticated Plant Fruit Wikipedia
Citrus tamurana	Hyuganatsu	Domesticated Plant Fruit Wikipedia
Citrus tangerina	Tangerine	Domesticated Plant Fruit Wikipedia
Citrus unshiu	Satsuma mandarin	Domesticated Plant Fruit Wikipedia
Coccoloba diversifolia	Pigeon plum	Domesticated Plant Fruit Wikipedia
Cocos nucifera var. aurantiaca	King coconut	Domesticated Plant Fruit Wikipedia
Cornus × unalaschkensis	Alaskan bunchberry	Domesticated Plant Fruit Wikipedia
Cornus canadensis	Canadian bunchberry	Domesticated Plant Fruit Wikipedia
Crataegus rhipidophylla	Hawthorn	Domesticated Plant Fruit Wikipedia
Cucumis melo 'Collective Farm Woman Melon'	Collective farm woman melon	Domesticated Plant Fruit Wikipedia
Cucumis melo 'Crane Melon'	Crane melon	Domesticated Plant Fruit Wikipedia
Cucumis melo 'Crenshaw Melon'	Crenshaw melon	Domesticated Plant Fruit Wikipedia
Cucumis melo 'Sprite Melon'	Sprite melon	Domesticated Plant Fruit Wikipedia
Cucumis melo 'Tigger Melon'	Tigger melon	Domesticated Plant Fruit Wikipedia
Cucumis melo var. cantalupensis	European cantaloupe	Domesticated Plant Fruit Wikipedia
Cucumis melo var. inodorus	Honeydew melon	Domesticated Plant Fruit Wikipedia
Cucumis melo var. inodorus 'Bailan Melon'	Bailan melon	Domesticated Plant Fruit Wikipedia
Cucumis melo var. inodorus 'Canary Melon'	Canary melon	Domesticated Plant Fruit Wikipedia
Cucumis melo var. inodorus 'Santa Claus Melon'	Santa Claus melon	Domesticated Plant Fruit Wikipedia
Cucumis melo var. makuwa	Korean melon	Domesticated Plant Fruit Wikipedia
Cucumis melo var. reticulatus	North American cantaloupe	Domesticated Plant Fruit Wikipedia
Dacrycarpus dacrydioides	Kahikatea	Domesticated Plant Fruit Wikipedia
Dacrydium cupressinum	Rimu	Domesticated Plant Fruit Wikipedia
Davidsonia jerseyana	Davidson's plum	Domesticated Plant Fruit Wikipedia
Davidsonia johnsonii	Smooth davidson's plum	Domesticated Plant Fruit Wikipedia
Davidsonia pruriens	Ooray	Domesticated Plant Fruit Wikipedia
Dialium cochinchinense	Velvet tamarind	Domesticated Plant Fruit Wikipedia
Dillenia indica	Elephant apple	Domesticated Plant Fruit Wikipedia
Dimocarpus Longan	Longan	Domesticated Plant Fruit Wikipedia
Diospyros nigra	Black sapote	Domesticated Plant Fruit Wikipedia
Diploglottis campbellii	Small-leaved tamarind	Domesticated Plant Fruit Wikipedia
Duguetia confinis	Duguetia confinis	Domesticated Plant Fruit Wikipedia
Duguetia spixiana	Duguetia spixiana	Domesticated Plant Fruit Wikipedia
Elaeagnus multiflora	Cherry elaeagnus	Domesticated Plant Fruit Wikipedia
Eleiodoxa conferta	Asam kelubi	Domesticated Plant Fruit Wikipedia
Empetrum nigrum	Crowberry	Domesticated Plant Fruit Wikipedia
Euclea crispa	Blue guarri	Domesticated Plant Fruit Wikipedia
Eugenia luschnathiana	Pitomba-da-bahia	Domesticated Plant Fruit Wikipedia
Eugenia reinwardtiana	Cedar Bay cherry	Domesticated Plant Fruit Wikipedia
Eupomatia laurina	Bolwarra	Domesticated Plant Fruit Wikipedia
Exocarpos cupressiformis	Native cherry	Domesticated Plant Fruit Wikipedia
Feijoa sellowiana	Feijoa	Domesticated Plant Fruit Wikipedia
Ficus aurea	Strangler fig	Domesticated Plant Fruit Wikipedia
Ficus carrii	Ficus carrii	Domesticated Plant Fruit Wikipedia
Ficus coronata	Sandpaper fig	Domesticated Plant Fruit Wikipedia
Ficus platypoda	Desert fig	Domesticated Plant Fruit Wikipedia
Ficus racemosa	Cluster fig	Domesticated Plant Fruit Wikipedia
Ficus virens	White fig	Domesticated Plant Fruit Wikipedia
Garcinia forbesii	Garcinia forbesii	Domesticated Plant Fruit Wikipedia
Garcinia gummi-gutta	Garcinia cambogia	Domesticated Plant Fruit Wikipedia
Garcinia humilis	Achacha	Domesticated Plant Fruit Wikipedia
Garcinia parvifolia	Kundong	Domesticated Plant Fruit Wikipedia
Garcinia prainiana	Button mangosteen	Domesticated Plant Fruit Wikipedia
Gaultheria hispida	Copperleaf snowberry	Domesticated Plant Fruit Wikipedia
Gaultheria procumbens	Eastern teaberry	Domesticated Plant Fruit Wikipedia
Glenniea philippinensis	Glenniea philippinensis	Domesticated Plant Fruit Wikipedia
Gomortega keule	Gomortega	Domesticated Plant Fruit Wikipedia
Grewia retusifolia	Emu berry	Domesticated Plant Fruit Wikipedia
Heteromeles arbutifolia	Toyon	Domesticated Plant Fruit Wikipedia
Hydnora abyssinica	Hydnora abyssinica	Domesticated Plant Fruit Wikipedia
Hylocereus undatus	Dragon fruit	Domesticated Plant Fruit Wikipedia
Juniperus communis	Juniper berry	Domesticated Plant Fruit Wikipedia
Lansium parasiticum	Langsat	Domesticated Plant Fruit Wikipedia
Lardizabala biternata	Lardizabala	Domesticated Plant Fruit Wikipedia
Lodoicea maldivica	Sea coconut	Domesticated Plant Fruit Wikipedia
Lonicera periclymenum	Honeysuckle	Domesticated Plant Fruit Wikipedia
Maclura tricuspidata	Cudrang	Domesticated Plant Fruit Wikipedia
Mahonia aquifolium	Oregon grape	Domesticated Plant Fruit Wikipedia
Malus niedzwetzkyana	Niedzwetzky's apple	Domesticated Plant Fruit Wikipedia
Malus pumila	Apple	Domesticated Plant Fruit Wikipedia
Manilkara kauki	Wongi	Domesticated Plant Fruit Wikipedia
Manoao colensoi	Manoao	Domesticated Plant Fruit Wikipedia
Melastoma affine	Blue tongue	Domesticated Plant Fruit Wikipedia
Melodorum leichhardtii	Zig-zag vine fruit	Domesticated Plant Fruit Wikipedia
Mimusops elengi	Spanish cherry	Domesticated Plant Fruit Wikipedia
Morinda citrifolia	Noni	Domesticated Plant Fruit Wikipedia
Morus alba	White mulberry	Domesticated Plant Fruit Wikipedia
Murraya koenigii	Curry berry	Domesticated Plant Fruit Wikipedia
Myrciaria floribunda	Guavaberry	Domesticated Plant Fruit Wikipedia
Myrica rubra	Yangmei	Domesticated Plant Fruit Wikipedia
Nageia nagi	Nageia	Domesticated Plant Fruit Wikipedia
Nephelium hypoleucum	Korlan	Domesticated Plant Fruit Wikipedia
Nephelium mutabile	Pulasan	Domesticated Plant Fruit Wikipedia
Nephelium xerospermoides	Hairless rambutan	Domesticated Plant Fruit Wikipedia
Opuntia ficus-indica	Prickly pear fruit	Domesticated Plant Fruit Wikipedia
Owenia acidula	Emu apple	Domesticated Plant Fruit Wikipedia
Pandanus tectorius	Hala fruit	Domesticated Plant Fruit Wikipedia
Parajubaea torallyi	Bolivian mountain coconut	Domesticated Plant Fruit Wikipedia
Passiflora edulis f flavicarpa	Yellow granadilla	Domesticated Plant Fruit Wikipedia
Pentadiplandra brazzeana	Pentadiplandra brazzeana	Domesticated Plant Fruit Wikipedia
Planchonia careya	Cocky apple	Domesticated Plant Fruit Wikipedia
Pleiogynium timoriense	Burdekin plum	Domesticated Plant Fruit Wikipedia
Podocarpus elatus	Plum pine fruit	Domesticated Plant Fruit Wikipedia
Podocarpus elongatus	Podocarpus	Domesticated Plant Fruit Wikipedia
Podocarpus totara	Totara	Domesticated Plant Fruit Wikipedia
Podophyllum peltatum	Mayapple	Domesticated Plant Fruit Wikipedia
Pouteria australis	Black apple	Domesticated Plant Fruit Wikipedia
Prumnopitys andina	Prumnopitys	Domesticated Plant Fruit Wikipedia
Prunus persica var. nucipersica	Nectarine	Domesticated Plant Fruit Wikipedia
Prunus salicina spp.	Kelsey plum	Domesticated Plant Fruit Wikipedia
Prunus umbellata	Flatwoods plum	Domesticated Plant Fruit Wikipedia
Prunus virginiana	Choke cherry	Domesticated Plant Fruit Wikipedia
Pseudocydonia sinensis	Chinese quince	Domesticated Plant Fruit Wikipedia
Psidium rufum	Purple guava	Domesticated Plant Fruit Wikipedia
Pyracantha coccinea	Scarlet firethorn	Domesticated Plant Fruit Wikipedia
Quararibea cordata	South American sapote	Domesticated Plant Fruit Wikipedia
Rheum × hybridum	Rhubarb	Domesticated Plant Fruit Wikipedia
Rollinia deliciosa	Biribá	Domesticated Plant Fruit Wikipedia
Rosa rugosa	Rose hip	Domesticated Plant Fruit Wikipedia
Rubus adenotrichos	Mora común	Domesticated Plant Fruit Wikipedia
Rubus allegheniensis	Blackberry	Domesticated Plant Fruit Wikipedia
Rubus caesius 'Youngberry'	Youngberry	Domesticated Plant Fruit Wikipedia
Rubus fruticosus × rubus idaeus	Tayberry	Domesticated Plant Fruit Wikipedia
Rubus hayata-koidzumii	Creeping raspberry	Domesticated Plant Fruit Wikipedia
Rubus leucodermis	White bark raspberry	Domesticated Plant Fruit Wikipedia
Rubus moluccanus	Molucca bramble berry	Domesticated Plant Fruit Wikipedia
Rubus parviflorus	Thimbleberry	Domesticated Plant Fruit Wikipedia
Rubus probus	Atherton raspberry	Domesticated Plant Fruit Wikipedia
Rubus strigosus	American red raspberry	Domesticated Plant Fruit Wikipedia
Rubus ursinus × rubus idaeus	Boysenberry	Domesticated Plant Fruit Wikipedia
Sageretia theezans	Sageretia	Domesticated Plant Fruit Wikipedia
Sambucus pubens	American red elderberry	Domesticated Plant Fruit Wikipedia
Serenoa repens	Saw palmetto fruit	Domesticated Plant Fruit Wikipedia
Siraitia grosvenorii	Luóhàn guǒ	Domesticated Plant Fruit Wikipedia
Sorbopyrus irregularis	Shipova	Domesticated Plant Fruit Wikipedia
Syzygium australe	Brush cherry	Domesticated Plant Fruit Wikipedia
Syzygium fibrosum	Fibrous satinash	Domesticated Plant Fruit Wikipedia
Syzygium luehmannii	Riberry	Domesticated Plant Fruit Wikipedia
Syzygium suborbiculare	Red bush apple	Domesticated Plant Fruit Wikipedia
Terminalia carpentariae	Wild peach	Domesticated Plant Fruit Wikipedia
Terminalia ferdinandiana	Gubinge	Domesticated Plant Fruit Wikipedia
Trichosanthes beccariana	Trichosanthes beccariana	Domesticated Plant Fruit Wikipedia
Vaccinium ovatum	Huckleberry	Domesticated Plant Fruit Wikipedia
Vaccinium parvifolium	Red huckleberry	Domesticated Plant Fruit Wikipedia
Vaccinium vitis-idaea	Lingonberry	Domesticated Plant Fruit Wikipedia
Viburnum lentago	Nannyberry	Domesticated Plant Fruit Wikipedia
Agave fourcroydes	Sisal	Domesticated Plant Other Wikipedia
Cannabis indica	Marijuana	Domesticated Plant Other Wikipedia
Cinnamomum verum	Cinnamon	Domesticated Plant Other Wikipedia
Cola acuminata	Cola	Domesticated Plant Other Wikipedia
Corchorus capsularis	White Jute	Domesticated Plant Other Wikipedia
Croceus sativus	Saffron	Domesticated Plant Other Wikipedia
Cuminum cyminum	Cumin	Domesticated Plant Other Wikipedia
Cymbopogon	Lemongrass	Domesticated Plant Other Wikipedia
Gossypium	Cotton	Domesticated Plant Other Wikipedia
Gylcine max	Soybean	Domesticated Plant Other Wikipedia
Hibiscus cannabinus	Kenaf	Domesticated Plant Other Wikipedia
Jasminum	Jasmine	Domesticated Plant Other Wikipedia
Mentha balsamea	Peppermint	Domesticated Plant Other Wikipedia
Mentha spicata	Spearmint	Domesticated Plant Other Wikipedia
Nicotiana tabacum	Tobacco	Domesticated Plant Other Wikipedia
Origanum vulgare	Oregano	Domesticated Plant Other Wikipedia
Salvia rosmarinus	Rosemary	Domesticated Plant Other Wikipedia
Spirodela polyrhiza	Giant duckweed	Domesticated Plant Other Wikipedia
Theobroma cacoa	Chocolate	Domesticated Plant Other Wikipedia
Thinopyrum intermedium	intermediate wheatgrass	Domesticated Plant Other Wikipedia
Thymus vulgaris	Thyme	Domesticated Plant Other Wikipedia
Saccharomyces cerevisiae	Beer Yeast	Domesticated Fungus Wikipedia
Amaranthus hybridus	c("green pigweed", "smooth amaranth", "smooth pigweed", "slim amaranth")	Domesticated Plant Student
Brassica rupestris	mustard	Domesticated Plant Student
Cercocebus atys	Sooty Mangabey	Domesticated Plant Student
Citrus aurantiifolia	Key Lime	Domesticated Plant Student
Citrus aurantium	sour orange	Domesticated Plant Student
Citrus sinensis	Sweet orange	Domesticated Plant Student
Coturnix japonica	Japanese Quail	Domesticated Plant Student
Dioscorea	Yams	Domesticated Plant Student
Fragaria x ananassa	Strawberry	Domesticated Plant Student
Linanthus pungens	granite prickly phlox	Domesticated Plant Student
Linum bienne	pale flax	Domesticated Plant Student
Pogostemon cablin	patchouli	Domesticated Plant Student
Apis mellifera	c("honey bee", "abeille domestique")	Domesticated Animal Student
Melopsittacus undulatus	Budgerigar	Domesticated Animal Student
Rattus rattus	c("rat noir", "House Rat", "Black Rat", "Roof Rat")	Domesticated Animal Student
